stress	estresa
weep	negar
manipulation	manipulazioa
unsavory	gaiztoa
cozy	atsegina
brood	iruzurra
disappointing	etsigarriak
ignominy	ezjakintasuna
insensitively	sentsibilitatea
hazardous	arriskutsuak
strained	estutu
noisier	zaratatsuagoa
villainously	gaizki
achievements	lorpenak
sabotage	sabotajea
latency	latentzia
prevaricate	predikatu
honorable	ohoragarria
fear	beldurra
criticisms	kritikak
cheap	merkea
sweeping	miaketa
quarrellously	bortizki
prompt	galdetu
intriguingly	intrigazkoa
incomparably	konparatiboki
sacrificed	sakrifikatu
colorful	koloretsua
ill-natured	gaiztoa
splendidly	zoragarria
obsolete	zaharkitua
undercutting	ahultzen
rapid	azkar
disappointingly	etsipenez
monumental	monumentala
pricier	arinagoa
loved	maitatua
solicitude	eskaera
flagging	markatzea
furious	amorruz
comprehensive	integrala
trendy	modan
wrinkles	zimurrak
negligent	negligenteak
winners	irabazleak
economical	ekonomikoa
maliciously	gaizki
quarrelsome	larriagotu
shortchange	engainatu
dissemble	desegiteko
fluent	mingarria
chivalry	zaldiketa
manipulative	manipulatzailea
opponent	aurkaria
loyal	leial
worry	kezkatu
desirous	nahiago
excuse	aitzakia
unprove	apaldu
evil	gaiztoak
chaff	mafia
unsettling	aztoratzen
brilliance	distira
stately	dotorea
tarnishes	txarrak
crime	delitua
ameliorate	hobetu
stagnate	gelditu
inordinately	ezohiko
renowned	ezagunak
excitingly	zirraragarria
friendly	atsegina
malignant	gaiztoa
disaffected	deszifratu
invidiousness	inertzia
swift	azkar
trustworthy	fidagarria
affably	afable
radicals	erradikalak
injudicious	kaltegarriak
relentless	nekaezinean
oppose	aurka
shiny	distiratsua
fanaticism	fanatismoa
ricer	aberatsa
scandels	eskandelak
simplistic	sinplista
apprehensions	atxiloketak
victory	garaipena
helping	laguntzen
idiot	idiota
dwindling	ahultzen
autonomous	autonomoa
astounding	harrigarria
excellency	bikaintasuna
retractable	erretraktila
divergent	desberdina
infringements	arau-hauste
overstated	oztopatu
undue	desegoki
nuisance	gogaikarriak
jagged	zertxobait
discrimination	diskriminazioa
unqualified	ez-gaitu
virulently	birulentzia
shatter	desegin
faulty	okerra
ruined	hondatuta
complemented	osatua
rejected	baztertua
admirer	miresgarria
bleeds	odoletan
killer	hiltzailea
subtract	kendu
loses	galtzen
stunning	harrigarri
patronize	babestu
respectful	errespetuzkoa
cleaner	garbiago
glare	distira
remorselessness	gogaikarriak
blunt	lauso
thoughtlessness	pentsamendua
hopelessness	desesperantza
refund	itzultzea
beauty	edertasuna
favor	alde
aggressive	oldarkorra
delays	atzerapenak
whining	kexatzen
appallingly	apalki
irreconcilable	ezinezkoa
oppositions	oposizioak
rattles	zurrumurruak
likes	atsegin
overlook	ahaztu
depress	presaka
hostilities	ostatuak
limit	muga
alienation	alienazioa
accost	akordeak
charming	xarmangarri
subpoenas	aipamenak
sociable	soziala
refine	findu
brashly	zorrotz
ingenious	ingeniaria
languorously	languishly
apotheosis	apoteosi
inspire	inspiratu
brisk	bizkor
dust	hautsa
grim	gaizkia
undefined	zehaztugabea
bombard	bonbardatu
cheats	tranparik
heroine	heroina
superstition	sineskeria
irredeemably	irribarrez
exhaustion	nekea
charismatic	karismatikoa
condescension	kondentsazioa
luck	zorte
solace	kontsolamendua
acridness	zorrotz
crushing	birrintzeko
wonderfully	zoragarria
pleasure	plazerra
insolently	ezohiko
inconsistencies	inkongruentziak
hallmarks	ezaugarri
affluence	aberastasuna
obese	obesitatea
unattractive	itsusi
prejudices	aurreiritziak
spacious	zabala
extremist	muturrekoa
begging	eske
non-violent	ez-bortitza
gratefully	zorionez
censure	zentsura
prohibit	debekatu
repetitive	errepikakorra
issue-free	gai-free
reasoned	arrazoitua
steadfast	gogorra
warm	bero
delightfully	zoragarria
tired	nekatuta
punishable	zigor
integrated	integratua
profuse	profusa
shake	astindu
hardened	gogortua
inconsistence	inkontzientea
enemy	etsaia
flawlessly	perfektua
chatter	txata
attune	joera
retaliatory	erretalia
spectacularly	ikusgarria
weariness	nekea
misconceptions	okerrak
inflationary	inflazioa
incompetence	ezintasuna
sloppily	zoritxarrez
threat	mehatxua
sensibly	zentzuzkoa
impeccable	zaindua
ruin	hondamena
noxious	nazkagarri
reachable	eskuragarria
racist	arrazista
threats	mehatxuak
convenient	komenigarria
rift	bortxaketa
revolting	iraultza
breakdown	matxura
obstructs	oztopoak
injury	lesioak
abrupt	bortitza
valor	balio
buoyant	boikot
brutalising	bortitz
extravagant	bitxiak
qualms	maltzurkeria
diffidence	ezintasuna
gainsayer	irabazleak
complimentary	osagarriak
trusted	fidagarria
treasonous	traidorea
commotion	bozgorailua
conspicuously	nabarmenki
hegemonistic	hegemonistikoa
dissonance	disonantzia
enviably	inbidia
stereotype	estereotipo
vibrant	bizia
loot	harrapakin
orderly	ordenatua
utterly	guztiz
compulsive	konpultsiboa
tyrannical	tiranikoa
finagle	finak
unusual	ezohikoa
distress	apuros
genuine	benetakoa
sickness	gaixotasuna
hinder	oztopatzen
suffers	sufritzen
usable	erabilgarriak
inferior	behean
degrade	degradatu
stirringly	harrigarria
overwhelm	zoritxarrez
refusal	ukatzea
imperfect	inperfektua
amaze	harritu
overpaid	gehiegizkoa
sunk	hondoratuta
heavyhearted	atsekabetua
inapt	ezgai
intense	bizia
insidiously	maltzurki
proprietary	jabeduna
brainy	burusoila
honor	ohorea
deceive	engainatu
support	laguntza
weirdly	bitxi
breakthroughs	aurrerapenak
mystify	mistifikatu
destiny	patua
dedicated	dedikatu
profane	profanoak
fist	ukabila
shamelessness	lotsagabekeria
calamities	kalamities
atrocious	itzel
originality	originaltasuna
levity	leialtasuna
anxiety	antsietatea
sillily	tonto
spellbound	idazkera
examplary	azterketa
lively	bizia
usurp	usurpatu
kudos	zorionak
fearless	beldurrez
smuttier	smutter
dishonestly	gaizki
expensive	garestia
demise	desagertzea
vivacious	bizia
woeful	zorigaiztoko
smoothly	leuna
horrendous	izugarria
commendably	zorionez
sobering	serio
impropriety	gaizki
revulsive	indarkeria
masterfully	maisuki
tedious	lapurtera
annihilation	desagerpena
vileness	zentzugabekeria
offender	delitu
brimstone	srimoia
morons	tontoak
horrid	izugarria
stale	ahaztuta
enjoying	gozatzen
slap	belarrondoko
taboo	tabu
joke	txantxa
confess	aitortu
gainsay	irabazi
swelled	hantura
palatial	palataria
smuttiest	smutest
enjoy	gozatu
joyful	pozik
knowledgeable	ezagutza
sufferers	gaixoak
appal	eskaintza
deaf	gorrentzako
resolute	erabakigarria
confounding	nahastu
logical	logikoa
adequate	egokia
apologists	apologoak
suicide	suizidioa
inconsequentially	ezegonkortasunez
outraged	indarkeria
wickedly	gaizki
paucity	apur
sorrow	atsegabea
disvalue	desegitea
cracked	pitzatu
trusting	fidagarria
humour	umorea
unsteady	ezegonkor
genocide	genozidioa
disaffect	desadostasuna
courteous	kortesoa
forbidding	debekua
arcane	arcano
harassed	zauritu
wildly	larriki
invalid	baliogabea
antagonist	antagonista
vestiges	aztarnak
significant	esanguratsua
clamor	klamurra
stifling	usteldu
disgusting	nazkagarria
perish	galdu
incompatible	bateraezina
inconsequential	ezezagunak
helpless	babesgabe
uproot	erretzea
steeply	zurrunbilo
credible	sinesgarria
tense	tentsioa
smiles	irribarreak
cheery	zorionak
pitifully	zoritxarrez
rigid	zurrunak
humorously	umorez
faithless	sinestea
sensation	sentsazioa
sporty	kirol
gravely	larriki
dissapointed	deboziozkoak
slowly	poliki-poliki
screwed	bihurritu
inhibition	inhibizioa
valiantly	ausarki
strut	zutik
foolishly	ergelki
illusory	ilusioz
obnoxious	gorrotagarri
roomier	aretoagoa
obsessively	obsesiboki
intolerance	intolerantzia
fierce	gogorra
orphan	umezurtz
enrapt	desegin
retract	erretiratzea
propitiously	egokia
cranky	txundigarria
shambles	errautsak
suspicions	susmoak
leading	liderra
carelessness	arduragabekeria
worthlessly	ezerez
slowww	motel
trust	konfiantza
conceded	onartuta
obscenely	lizun
sarcasm	sarcasmo
fraught	beteta
franticly	frenetically
skepticism	eszeptizismoa
freshest	freskoena
quandary	galdeketa
permissible	onartezina
gruesome	gogorra
unilateralism	unilateralismoa
contemptuous	desengainu
displeasure	atsekabetu
beg	eskatu
inadequacy	ezegokitasuna
healthful	osasuntsua
pre-eminent	preeminente
soundness	soiltasuna
yawn	bozgorailua
drought	lehortea
strike	greba
genius	jenio
shortcoming	hutsuneak
traitorously	traidore
foolish	erokeria
atrophy	atrofia
lawbreaking	legegintzaldia
dignity	duintasuna
eventful	ausazkoa
insidious	maltzurragoa
subsidizes	diru-laguntzak
win	irabazi
marginally	marginalki
evasive	iheskorra
accomplishment	lorpena
simpler	errazagoa
hating	gorrotatzen
moan	kexatu
quarrellous	gezurrak
stupendous	zoragarria
irreversible	atzeraezina
fears	beldurrak
clouding	hodeiak
inexplainable	ezinezkoa
reward	saria
corruption	ustelkeria
unspeakablely	ezezaguna
divinely	jainkotiarra
favorite	gogokoena
bizarre	bizarra
recommend	gomendatzen
rape	bortxaketa
terribleness	izugarri
fatigued	nekatuta
quarrels	liskarrak
subversive	subertsiboa
humorous	umoretsua
meaningful	esanguratsua
accursed	maltzurrez
tidy	txukuna
humane	gizatiarra
lied	gezurra
benefit	onura
insolence	hutsegitea
tantrum	birrindu
fidelity	fideltasuna
delinquent	delincuente
unsustainable	jasanezin
scolding	eskarmentu
ambiguity	anbiguotasuna
heartily	zorionez
irrationally	irrazionalki
madness	eromena
improper	gaizki
hatred	gorrotoa
encourage	animatu
gloriously	gloriosa
sour	gatza
everlasting	betiko
bloodthirsty	basatia
degrading	degradatzea
annihilate	desegin
butchery	harategia
longingly	betirako
exploit	ustiatu
desertion	deserria
brutally	bortitz
wheedle	zurrumurrua
spews	egozten
luxurious	luxuzko
deception	iruzur
considerate	gogoan
criticize	kritikatu
disintegrated	desegin
annoyed	gogaitua
boil	iraki
simplest	errazena
prejudice	kalterik
trumpet	tronpeta
kills	hiltzen
corruptted	hondatuta
combust	konketa
feisty	zorigaiztoko
acrimoniously	zorrotz
cave	haitzuloa
exile	erbestea
rejuvenating	gaztetzea
impulsive	oldartsu
puzzlement	zorrotz
unjustifiable	injustifikagarria
outstanding	nabarmena
marvelled	zoragarria
sick	gaixoa
impenitent	inplizituki
farfetched	zoragarria
preposterous	zoragarria
betrayal	traizio
sloow	motel
opportunistic	oportunista
stalemate	gelditu
stalls	besaulki-patioak
lags	atzerapenak
liberate	askatu
monstrous	munstroa
overloaded	gainkargatuta
self-satisfaction	autoestima
insecure	segurua
wounds	zauriak
disorganized	desorganizatua
deadlock	blokeatuta
regrets	atsekabetzen
grotesque	groteskoa
cynical	zinikoa
eager	irrikaz
remission	barkamena
reforms	erreformak
succeeding	arrakastaz
repulsing	errebotea
obstruction	oztopoak
peaceable	baketsua
acerbically	akerbiko
insincerity	ezintasuna
supurbly	goibel
revolutionizes	iraultzen
disinterest	desinteresatu
convincingly	konbentzionalki
hypocrites	hipokritak
fastest	azkarrena
vomit	oka
shock	harritu
crueler	krudela
impediment	inpedantzia
curt	labur
obsession	obsesioa
horrify	izutur
capsize	gorpuztu
proving	frogatzen
sadness	tristura
invidious	inbidia
bent	okertua
bores	aspertzen
frenzy	frenesi
lunatic	lunatikoa
seriousness	seriotasuna
imprisonment	espetxeratzea
exhausted	agortu
incoherence	inkoherentzia
antiquated	zaharkitua
defender	defendatzailea
cheaply	merkea
seethe	haserre
endorse	onartu
nastiness	nazka
delay	atzerapena
snappish	zorrotz
succeed	arrakasta
addicting	mendekotasun-sortzaile
deviously	nazka
anti-american	anti-amerikarra
reforming	erreforma
smile	irribarre
remorseful	errukitsua
annoying	gogaikarriak
rusty	oxidoa
perverse	gaiztoa
safely	segurtasunez
winning	irabazle
promised	agindua
clumsy	baldarra
fat-cat	gantz-katua
reviled	gaitzespena
vainly	harro
disconcertingly	ezezaguna
mistified	mistiki
generosity	eskuzabaltasuna
eloquent	elokuenteak
laughable	barreagarria
awkwardness	trakestasuna
fanciful	fantasiazko
impolitic	inpolitikoa
wane	galtzen
flatteringly	zorionez
astonishing	harrigarria
absurdity	absurdua
ideally	idealean
soothe	lasaitu
wonder	galdetu
affirmation	baieztapena
flighty	harrigarria
darling	maitea
ghastly	izugarri
rejecting	baztertzen
thankless	eskerrak
advantages	abantailak
inescapable	ezinezkoa
unnervingly	larrigarri
antipathy	antipatia
unpleasantries	desatsegina
obliterated	ezabatua
spoiled	hondatu
discomfort	deserosotasuna
fallacy	falazia
crooks	lapurrak
plebeian	plebeia
favour	alde
rebuke	errebotea
cheated	engainatu
ambiguous	anbiguoa
vibrating	bibrazio
curse	madarikazioa
enervate	bozkatu
creepy	beldurgarria
discourteous	desatsegina
ironically	ironikoki
deficiencies	gabeziak
ailment	gaixotasuna
corrupted	hondatuta
approve	onestea
ridicule	irrigarri
nettlesome	neskatila
maturity	mugaeguna
stain	orban
futile	inozoa
strictly	zorrozki
overrun	inbaditu
nightmare	amesgaiztoa
misleading	engainagarria
angriness	haserre
butcher	harategia
distorts	distortsioak
fallout	erori
grossly	gordin
stability	egonkortasuna
playfully	jolastu
excellence	bikaintasuna
fabricate	fabrikatu
torture	tortura
inferiority	gutxiagotasuna
protect	babestu
illogically	ilogikoki
anguish	larritasuna
gaining	irabazten
exhaust	ihes
over-balanced	orekatua
harmed	kaltetu
infected	kutsatuta
combative	borrokalaria
best-known	ezagunena
enhanced	hobetu
desperate	etsi
denounce	salatu
love	maitasuna
hostile	etsaiak
deceiving	engainatzen
virtuous	virtuoso
kindliness	atsegina
controversial	polemikoa
magnificence	handitasuna
nauseate	nazkatu
ineffective	eraginkorra
unhappiness	zorigaitza
fugitive	iheslari
careless	arduragabekeria
affliction	afrikarekiko
unforgiving	eskuzabala
mushy	mingots
implacable	errugabea
wasteful	alferrikakoa
fortune	fortuna
youthful	gazteak
hate	gorrotoa
hail	txingorra
eye-catch	begi-harrapaketa
wonders	galdetzen
pugnaciously	pugnazously
enthrall	zoragarria
inflated	puztuta
substandard	azpikate
oppressive	zapaltzaileak
tragic	tragikoa
sharpest	zorrotzagoa
idolized	idolizatua
senselessly	zentzugabekeria
breathtakingly	harrigarriro
vociferous	bozgorailua
overwhelms	zoritxarrez
odder	bitxiagoa
antagonistic	antagonista
marvels	zorionak
pathetically	patetikoki
splendor	distira
ruins	hondarrak
catchy	gogoraerrazak
divisiveness	zatiketa
scandalized	eskandalizatua
regressive	regresiva
emaciated	emaztea
chaotic	kaotikoa
congratulate	zorionak
breathlessness	arnasa
charisma	karisma
quaint	pintxoak
manipulators	manipulatzaileak
famished	ospetsu
deprived	pribatua
lover	maitalea
pillory	pikoria
funnily	dibertigarria
unsuspecting	fidakor
criticism	kritika
accomplishments	lorpenak
damaging	kaltegarriak
exaggerate	exageratzea
strikingly	zoragarria
ironic	ironikoa
struggling	borrokan
spilling	isurketak
magnificent	bikaina
animosity	animositatea
impartiality	inpartzialtasuna
vehement	sutsua
sorely	mina
solid	ona
roomy	gelaxka
valuable	baliotsua
freeze	izoztu
cheerful	alaia
hatefully	gorrotoz
objection	objekzioa
spendy	pasahitza
shockingly	harrigarri
womanizer	emakume-zale
servitude	zerbitzura
scrambled	nahaskeria
steadfastly	etengabe
hopeful	itxaropentsua
hostility	etsaitasuna
stench	estutu
inclement	gaitzespena
indignant	indignado
fearfully	beldurrez
cripples	elbarrituak
hothead	liskartia
violation	urratzea
modern	modernoa
refinement	fintasun
preferable	hobe
rigidness	zurruntasuna
stressfully	estresagarria
passion	pasioa
tenaciously	tenazously
eminent	eminente
inconsiderately	ezezaguna
contrariness	kontrabandoa
subsidize	diru-laguntza
silent	isilik
motionless	geldirik
polished	leundua
disrespectfulness	irresponsabilitatea
idiots	idiotak
solemn	solemne
hamper	zikindu
nicer	hobeto
get-rich	aberatsa
shortcomings	hutsegiteak
harmful	kaltegarriak
handsome	ederra
steep	aldapatsuak
overheat	berotu
castigate	kastigatu
fever	sukarra
dissent	desadostasuna
bereavement	doluz
overzealously	gehiegizkoa
nervousness	urduritasuna
erratic	erratikoa
openness	irekitasuna
pluses	gehiago
notoriously	ezaguna
calm	lasai
enemies	etsaiak
misguided	misguide
smells	usainak
twinkly	gogotsu
satisfies	satisfe
smoulder	smolder
cheaper	merkeagoa
plush	felpa
instigators	instigatzaileak
lengthy	luzea
durable	iraunkorrak
restructure	berregituratu
futuristic	futurista
virtuously	biziki
improving	hobetzeko
smoother	leuna
fast	azkar
desititute	desiragarria
inexcusable	eskuzabala
fashionable	modan
hug	besarkada
fateful	zorigaitza
infiltrator	infiltrazio
revolutionize	iraultza
progressive	progresiboa
wonderously	zoragarria
liar	gezurti
flaw	akatsa
erodes	erodioak
uplifting	eredugarria
swelling	hantura
horrifying	izuturik
aggravate	larriagotu
bastard	bastardo
licentiously	lizentiously
superiority	nagusitasuna
ridicules	irrigarriak
disturbed	araztua
refutation	errefusatzea
fat-cats	gantz-katuak
downturns	jaitsierak
melodramatic	melodramatikoa
neurotically	neurotikoki
exquisite	dotorea
toll-free	dohainik
lukewarm	epeletan
overtaken	gainditu
impossible	ezinezkoa
crumble	desegin
unacceptable	onartezin
fictitious	fikziozkoak
clique	klikatu
miss	galdu
undependability	undependable
insanity	eromena
unrealistic	sinesgaitz
timely	puntuala
obstructing	oztopatzen
infiltrators	infiltratzaileak
incessantly	etengabe
luxury	luxua
friendliness	lagunartekoa
shortage	eskasia
alarmed	alarma
disappoints	deuseztapenak
worried	kezkatuta
allegations	alegazioak
cornerstone	giltza
daringly	ausartak
undisputed	ezusteko
bastards	bastardoak
dissuasive	disuasio
peril	arriskua
illegally	ilegalki
irritation	narritadura
steadfastness	egonkortasuna
prudent	zuhurra
warned	ohartarazi
ineloquently	inelookly
enthusiasm	ilusioa
neglect	ahaztea
refreshed	freskatu
cliched	klikatu
angrily	haserre
narrower	estuagoa
unhappy	zorigaiztoko
thrive	hazten
infernal	infernua
squabble	gogoa
tyrannically	tiranikoki
dead-on	hilda
monotony	monotonia
diabolic	diabolikoak
dissappointed	desabantailen
inflammation	hantura
strife	gatazka
hell	infernua
irresponsibly	irresponsiboki
swollen	puztuta
realistic	errealista
plague	izurria
tacky	txarra
balanced	orekatua
plunder	lapurreta
chilly	hotza
pollute	kutsatu
unviewable	ikusezina
trick	trikimailu
stampede	zigilua
dusty	hautsez
pardon	barkamena
staunch	zoragarria
beneficent	onuragarria
wasting	alferrik
breakups	hausturak
irony	ironia
torturing	torturatu
exceedingly	asko
fiery	sutsua
illness	gaixotasuna
tumbles	erorketak
meritorious	zoragarria
raped	bortxatua
mess	nahastu
slowwww	motel
wicked	gaiztoa
recovery	berreskuratzea
inattentive	ahaztuta
revoke	errebokatu
exaltingly	altxorra
scorn	baztertu
superbly	bikaina
dominated	nagusi
lamentably	zoritxarrez
succeeds	arrakasta
plentiful	ugaria
easy	erraza
felonious	zoriontsu
nettle	ortiga
stuck	itsatsita
beautifully	ederki
flourish	loratu
exclusion	bazterkeria
irretating	irretatea
tender	lizitazio
fascination	lilura
unfortunate	zorigaiztoko
disadvantage	desabantaila
easier	errazagoa
successfully	arrakastaz
deservedly	merezi
astonishingly	harrigarriro
vibrate	bibratu
stressful	estresagarria
lighter	arinagoa
rectification	zuzenketa
disloyalty	desleialtasuna
aspire	aspiratu
spoilage	hondatu
shame	lotsa
conciliate	konbikatu
zenith	gailurra
contentment	pozik
thumb-up	hatzgora
misfit	bihurria
thoughtfully	pentsakor
pitiable	zoragarria
blurred	lausotu
disapointing	zoritxarrez
frolic	fruitu
faithfully	fideltasunez
fanatical	fanatikoak
solicitously	eskatuz
progress	aurrerapena
forsake	utzi
omit	ahaztea
raptureous	izoztuak
isolated	isolatua
amicability	lagunartekoa
dexterously	zorrotz
subdued	kaltetuta
prosperity	oparotasuna
anti-white	anti-zuri
user-friendly	erabilerraza
melancholy	malenkonia
handsomely	ederki
lawfully	legez
havoc	hondamena
jealousness	jeloskortasuna
majestic	dotorea
violate	urratzen
overpower	gorrotoa
demoralize	desmoralizatzeko
tanks	tankeak
dissenter	disidentzia
charm	xarma
uncertain	inertzia
enhance	hobetu
controversy	polemika
romantic	erromantikoa
light-hearted	argi-bihotza
noise	zarata
fatigue	nekea
miserly	gaizki
revile	iraultza
refuted	errefutazioa
gloomy	iluna
fondness	zaletasuna
self-determination	autodeterminazioa
boring	aspergarria
sensational	sentsazionala
renown	ezaguna
backwardness	atzerantza
collapse	kolapsoa
astound	astindu
admonishment	kargu
manipulate	manipulatu
waste	hondakinak
surrender	errendizioa
temptation	tentazioa
reform	erreforma
radicalization	erradikalizazioa
downbeat	beheranzkoa
antithetical	antitetikoak
plot	lursailean
anarchist	anarkista
debase	zorroztasun
calumniously	lasai
faithfulness	fideltasuna
rival	aurkaria
supporter	laguntzaile
humor	umorea
sham	iruzur
whore	puta
fine	fina
harmony	harmonia
remunerate	ordaintzea
sink	hondoratu
empathize	enpatia
tarnishing	edatekoa
spitefully	gorrototsu
unequivocal	inequivocal
deprecate	deuseztatzea
law-abiding	lege-errespetua
falsehood	gezurra
rapture	erritmoa
worst	txarrena
stink	izurrite
fundamentalism	fundamentalismoa
heinous	zoragarria
impudently	lotsagabe
bristle	zuritu
mindless	gogaikarria
extremists	muturrekoak
reverent	ahaztezina
worn	gastatua
mortified	mortifikatua
deceitful	engainagarria
greed	gorrotoa
split	zatitu
rude	zakar
one-sided	bat-aldekoak
dirty	zikin
infallible	infalible
praise	laudorio
disputable	eztabaidagarria
innovation	berrikuntza
tank	depositua
spiteful	gorrototsu
unpleasant	desatsegina
smell	usaina
uneasily	deseroso
masterpiece	maisulana
jaw-dropping	beherakada
objectionable	objektiboa
turbulent	turbulentea
wrinkle	zimurra
dexterous	zoragarria
sustainability	iraunkortasuna
cohere	konbinatu
unlikely	nekez
heresy	heresia
grandeur	handitasuna
inadvisable	ezohikoa
traumatically	traumatikoki
enrich	aberastu
simplifying	sinplifikatzea
infringement	arau-hauste
hedge	estaldura
ruffle	erruleta
furor	amorru
disillusions	desilusioak
repugnance	errebindikazioa
nauseatingly	nazkatuz
mortifying	beldurrezko
incompetent	ezgai
layoff	despedida
agony	agonia
impedance	inpedantzia
exalting	goratzea
disgusted	atsekabetu
anemic	anemia
relentlessness	ergelkeria
inhospitality	ospitale
garbage	zaborra
erode	higatu
solidarity	elkartasuna
unquestionable	ezinbestekoa
occlude	ezkutatu
toughest	gogorra
hallowed	santua
illiterate	analfabetoa
abrasive	urratzailea
cuteness	zaintza
praiseworthy	zoragarria
unconstitutional	inkonstituzionala
blessing	bedeinkazioa
sweaty	izerdia
dismaying	lotsagarria
tentatively	tentagarria
collude	konplize
breakthrough	aurrerapena
obsess	obsesionatuta
instantly	berehala
prudence	zuhurtzia
togetherness	elkarrekin
remorseless	gogaikarria
regrettably	zoritxarrez
invincibility	invencibility
stubborn	zuhurra
inaccuracies	zehazgabeak
achievement	lorpen
disapointed	zoritxarrez
dejection	deiekzioa
selfishness	berekoitasuna
thwart	gelditu
resourceful	baliabide
luminous	argitsua
impinge	eragina
oblivious	ahaztuta
dissatisfying	desatsegina
stupid	ergelak
inimical	inimikoa
refuting	errefusatzea
unrivaled	paregabea
beneficial	onuragarria
problems	arazoak
strict	zorrotza
restless	geldiezina
excellently	bikaina
hard-liner	gogorra
anti-proliferation	antiproliferazioa
fiend	fedea
bumps	kolpeak
intoxicate	intoxikatu
personalized	pertsonalizatua
compulsion	konpultsioa
betrays	traizioak
fawningly	beldurrez
ardent	ardatza
retreat	erretiroa
rascals	bihurria
maneuverable	maniobragarria
confuses	nahastu
stereotypical	estereotipatu
frightful	beldurgarria
precariously	prekariatuta
revert	itzuli
freed	askatu
interruptions	etenaldiak
questionable	zalantzagarria
interfere	oztopatzeko
ragged	errautsak
brutalize	bortizatu
crook	erruduna
messy	nahastuta
shine	distira
heartbreaking	bihotz-erdiragarria
ineligible	ezinezkoa
pickets	piquetes
fatefully	zoritxarrez
hardhearted	gogorra
fragmented	zatikatua
radiant	distiratsu
disadvantages	desabantailak
flattering	zorionak
refute	errefusatu
hedonistic	hedonistikoa
decisive	erabakigarria
supreme	gorena
biting	ziztada
downheartedly	zorionez
illumine	illuminatu
plagiarize	plagiarizatu
defeat	garaipena
congested	konplexua
enough	nahikoa
unyielding	setati
destitution	desobedientzia
solicitous	eskatuz
conservative	kontserbadorea
aimless	helburua
brazenly	ausarki
mercy	errukia
enjoyment	gozamena
imprecision	zehaztugabetasuna
condemned	kondenatu
exemplary	eredugarria
spoon-feed	koilara-feed
sinfully	bekatari
fucking	madarikatu
wrip	urratu
clogs	zuloak
imaginative	irudimenezkoa
praising	laudorioa
hated	gorrotatua
self-criticism	autokritika
crass	txarra
commotions	bozgorailuak
decayed	desegin
dispirit	desaktibatuta
wreck	hondamena
secure	segurua
killed	hil
dismally	gaizki
sin	bekatua
ignorance	ezjakintasuna
buckle	belarria
denies	ukatzen
smouldering	smoldering
daring	ausartak
outbreak	lehertzea
negative	negatiboa
confidence	konfiantza
affection	afekzioa
adversary	aurkaria
stabilize	egonkortzea
dumped	desegin
lovely	ederra
spellbinding	ortografia
unemployed	langabezian
enrage	gorrotoa
mundane	ohiko
dirt-cheap	zikinkeria-merkea
slumpping	erorketa
alienate	baztertu
losing	galdua
happier	zoriontsuagoak
vomiting	oka
offenses	delituak
constructive	konstruktiboa
admirably	bikaina
glorious	gloriosa
upgradeable	berritze
desolately	desolatu
dogmatic	dogmatikoa
strangest	bitxikeriak
condemnation	gaitzespena
excuses	aitzakiak
galling	gantz
humiliate	umiliatu
tragically	tragikoki
suicidal	suizida
visionary	ikuslea
bore	aspertu
keenly	gogotsu
brighter	argiagoa
dropouts	abandonatuak
frenetic	frenetikoa
heavy-handed	zorrotza
richness	aberastasuna
bother	kezkatu
readable	irakurgarria
hurting	zauritzen
lunaticism	lunatikotasuna
tantalize	tantalizatu
defeated	garaitu
upsets	atsekabetzen
irregularity	irregularitatea
naive	inozoa
risks	arriskuak
jitters	hartzidura
dismayed	lotsagarria
trample	zapaldu
heroically	heroikoki
awfully	beldurgarri
incommensurate	urritasuna
crisis	krisia
liable	erantzule
versatility	aldakortasuna
evocative	iradokitzailea
excelent	bikaina
sorrowful	tristea
revolutionary	iraultzailea
casualty	zentzugabekeria
disappointments	desilusioak
sceptical	eszeptikoa
confident	ziur
rough	zakarra
woefully	zoritxarrez
brightest	distiratsuena
impatiently	etengabe
preferes	nahiago
poorest	pobreena
unfit	ezinduak
credulous	kredulua
reject	baztertu
pleasantly	atsegina
tragedy	tragedia
burns	erredurak
mercilessly	bihozgabe
tough	gogorra
well-being	ongizatea
shameless	lotsagabe
dictator	diktadorea
skittishly	lotsati
gains	irabaziak
presumptuously	ustez
clueless	esklabotza
discouraging	gezurra
relent	zurrumurrua
optimistic	baikor
friction	marruskadura
domineer	domina
strong	indartsua
inequalities	desberdintasunak
dreadfulness	beldurra
modest	apala
bumpping	ziztadak
patiently	pazientziaz
calamity	kalamity
despairingly	desesperingly
depraved	ahaztuta
willing	prest
monstrously	monstruoso
bothering	kezkatzen
partiality	partzialitatea
issues	gaiak
vague	lausoa
imaginary	irudimenezkoa
weaker	ahulagoa
sloppy	zoritxarrez
irresolvable	irresolgarria
untrue	gezurra
assurances	bermeak
volatility	lurrunkortasuna
limitation	mugaketa
commendable	komenigarria
darkened	ilunpean
torturously	torturantea
affront	afrentatu
reassurance	lasaitasuna
disturbing	kezkagarria
distinguished	bereizgarria
moribund	moribundoa
bonuses	hobariak
repudiation	ukatzea
forgetfully	ahaztuz
fascinate	liluratzen
liberty	askatasuna
unreliability	fidagaitasuna
merciless	bihozgabea
witty	zoragarria
generously	eskuzabal
heartfelt	zoriontsu
downturn	jaitsiera
elimination	ezabatzea
desirable	desiragarria
breaking	hausten
skeptical	eszeptikoa
tangle	nahasketa
laughably	barreka
traction	trakzioa
bogus	faltsua
lost	galdua
ignominious	ezjakinak
intrude	intrusioa
recant	errekurtsoa
overture	obertura
uneasiness	deserosotasuna
evils	gaitzak
improved	hobetu
unwise	zentzugabe
suppress	kendu
tainted	imitatu
apathetically	apatikoki
coherence	koherentzia
instability	ezegonkortasuna
acrid	akrilikoa
famous	ospetsua
disruption	etenaldia
desperately	etsipenez
gallingly	gaztea
loose	askorekin
disbelieve	ezkondu
saintliness	santasuna
abundance	ugaritasuna
mist	laino
rich	aberatsa
complementary	osagarri
rejuvenated	gaztetu
turmoil	turbulentzia
untruthful	gezurti
astounded	harritu
wound	zauria
endorsement	onarpena
decay	desintegrazioa
cruelties	krudelkeria
alienated	alienatua
caustically	kaustikoki
vicious	bihozgabe
parody	parodia
joyously	zorionez
healthy	osasuntsua
empower	indartu
trophy	garaikurra
illicit	ilegala
misgiving	zoritxarrez
advantageous	abantailatsua
defensive	defentsa
destructive	suntsitzailea
dizzingly	zorrotz
unleash	askatu
rumor	zurrumurrua
cooperatively	kooperatiboki
far-fetched	urrun
graceful	grazia
enthusiastic	gogotsu
attractively	erakargarri
coldly	hotz
suspect	susmagarri
viciousness	bihozgabekeria
fictional	fikziozkoak
calumniation	kalumnia
abolish	abolitu
backbone	bizkarrezurra
decisiveness	erabakitzeko
harden	gogoratu
poorer	pobreago
fearsome	beldurgarria
upsetting	atsekabe
frictions	frikzioak
convenience	erosotasuna
deteriorating	hondatzea
stylishly	dotorea
imminently	etengabe
detachable	desmunta
agile	arin
warlike	gudua
obtainable	eskuragarria
confined	mugatua
writhe	idatzi
disorder	desordena
famously	ospetsua
blissfully	zorionez
tyranny	tirania
intelligence	adimena
decrepitude	errudun
pitilessly	zoritxarrez
fatal	heriotza
remarkably	nabarmen
accessible	eskuragarria
appalled	eskas
catastrophe	hondamena
keen	gogotsua
corrosive	korrosiboak
compassionate	errukitsua
dauntless	laztana
well	ondo
disinclined	desinfektatu
undignified	lotsagarri
incorrectly	gaizki
frighten	beldurtu
jubilate	jubilatu
efficiently	eraginkortasunez
positively	positiboki
cataclysmic	kataklismikoa
marvelously	zoragarria
freedoms	askatasunak
straining	tentsioa
hectic	harrigarria
wretchedly	zoritxarrez
great	handia
desultory	desolatu
funny	dibertigarria
easygoing	erraza
acrimonious	zorrotz
protection	babes
inconceivably	ulertezina
urgent	urgentea
refusing	baztertzen
dissidents	disidenteak
celebratory	ospakizuna
distortion	distortsioa
manageable	kudeagarria
exceeding	gainditzea
coupists	kupoiak
lifeless	hilda
propitious	egokia
reluctant	errezeloa
cowardly	koldarra
enjoyable	atsegina
adulate	adulatu
trump	trumoia
biases	prezioak
incoherently	inkoherentea
criticizing	kritikatzen
unhealthy	osasungaitz
chaste	txakur
recomend	gomendatzen
shameful	lotsagarria
toughness	gogortasuna
uproarious	zalaparta
fertile	emankorrak
admonition	amonizazio
congratulation	zorionak
confusing	nahasgarria
sparkling	txinpartatsu
heretic	heretikoa
revolt	matxinada
unkindly	ezatsegin
disorderly	desordena
unfortunately	zoritxarrez
hypocritically	hipokritikoki
appreciative	estimagarria
demonized	demonizatu
slow	motela
impoverished	urritasuna
screwy	bihurritu
intimidation	intimidazioa
broke	hautsi
unable	ezin
cloudy	lainoak
bulkiness	bulkada
lazy	alferrak
presumptuous	ustez
richer	aberatsagoa
fanatic	fanatiko
picky	hautakorra
mirage	miraria
battering	bortxatzea
imbalance	desoreka
mature	helduak
troublesomely	gogaikarria
negate	negatiboa
distressingly	zoritxarrez
eyesore	begiak
hypocritical	hipokresia
energetic	energetikoa
astray	baztertu
regretted	damutu
needy	behartsu
caustic	kaustikoa
appalling	izugarria
dissuade	desegiteko
soreness	mina
restructuring	berregituratzea
wretch	zorigaiztoko
malodorous	malodoroak
displeased	desatsegin
astonishment	harridura
malaise	ezinegona
insightfully	sutsuki
favorable	ona
enthusiast	zalea
farce	fartsa
avidly	abidly
impunity	impunitatea
amazed	harritu
resignation	dimisioa
na√Øve	inozoa
strenuous	gogorra
unbearablely	jasanezin
triumph	garaipena
disdained	desatsegin
degeneration	endekapen
successful	arrakastaz
upliftingly	eredugarria
unspecified	zehaztugabea
atrocity	itzelkeria
sluggish	geldoegi
sturdier	gogorragoa
mockery	burla
wrath	haserre
stumbled	tropa
staunchness	lantzea
astonish	harrigarria
riled	irribarretsu
symptom	sintoma
intuitive	intuitiboa
gold	urrea
spewing	egotziz
overwhelmingly	erabatekoa
retaliate	erraldoi
cloud	hodeia
undid	desegina
provocation	probokazioa
fallacious	falazia
energy-efficient	energia-eraginkorra
discrepant	diskrepant
bug	akatsa
irrecoverablenesses	berreskuraezintasunak
siege	setioa
knife	labana
diss	dis
inconsequent	desegokiak
fallaciously	erori
slower	motelago
hardheaded	gogorra
empowerment	jabekuntza
implication	inplikazioa
stole	lapurtu
envious	inbidia
antagonism	antagonismo
thrift	alferrik
panicked	pankarta
treason	traizio
altruistic	altruista
backaching	kexatzen
exceptionally	salbuespenez
discouragement	desadostasuna
scams	iruzurrak
exultingly	zorionez
invasive	inbaditzaileak
torment	oinazea
groundbreaking	aitzindaria
cheapen	merkea
impractical	eskuzabala
poison	pozoia
gladness	zorionak
fractiously	hauskorra
pleasant	atsegina
discordance	desadostasuna
suitable	egokia
shemale	bizarra
euphoria	euforia
disrespectable	ezezaguna
euphorically	euforikoki
worthy	merezi
involuntary	nahigabeko
imminence	inimenak
displace	desplazatu
impudent	lotsagabe
disillusionment	desilusioa
regress	itzuli
helplessly	urritasuna
improvements	hobekuntzak
frustrated	zapuztuta
eloquence	elokuentzia
dictatorial	diktadorea
spite	gorrotoa
elegant	dotorea
fracture	haustura
worsen	larriagotu
disorient	desorientatua
protective	babeslea
revelation	errebelazioa
peacefully	bakean
baffled	nahastua
strident	zoragarria
wrest	kendu
promise	promesa
wripping	urratzen
joy	poza
fragile	hauskorra
feeblely	zoritxarrez
smallish	txikiak
picketing	piketea
penalty	zigorra
sneaky	isilean
disparaging	desberdintasun
forsaken	ahaztuta
sinking	hondoratzen
unwavering	gogorra
autocratic	autokrata
disadvantageous	desatsegina
delicacy	jaki
precarious	prekarioa
touchy	ukitu
pales	palak
prosperous	oparoa
warped	ahuldu
vibration	bibrazioak
victorious	garaile
stupidly	ergelki
delaying	atzeratzea
astutely	zoritxarrez
insolvent	konkurtsoa
diabolical	diaboliko
carnage	sarraskia
preferring	nahiago
capable	gai
imperil	inperio
mischievously	gaizki
disoriented	desorientatua
muddle	aldaketarik
sharply	nabarmenki
treasure	altxorra
selective	selektiboa
disrespectful	irresponsabilitatea
dump	iraulketa
contentious	kontuz
fearlessly	beldurrez
downer	behera
disagrees	desadostasunak
drips	jipoiak
stainless	herdoilgaitz
pride	harrotasuna
sardonically	sardonikoki
dishonest	gaizki
disunity	desunitatea
dumb	mutu
ulterior	geroago
enviousness	inbidia
malevolent	gaiztoa
precious	preziatuak
miracles	mirariak
smoothest	leunagoa
abounds	abound
endearing	liluragarria
inequality	desberdintasuna
critic	kritikaria
congenial	amankomea
woe	atsekabea
righteousness	zuzentasuna
allergies	alergiak
grudges	ahantziak
condemn	kondenatu
illusion	ilusioa
clash	borrokaldi
intelligible	ulergarria
unthinkable	pentsaezina
restlessness	lasaitasun
sweeten	gozatu
irredeemable	irribarrez
wearisome	nekatuta
racy	arrazista
greedy	diruzalea
recklessly	ustekabean
concen	kontzentrazioa
dismay	harridura
deformed	deformatua
hospitable	abegitsua
perfidious	perfidia
disaster	hondamendia
irately	gorrotoz
harmonize	harmonizatu
amenity	amenitatea
brutalizing	bortitzatzen
enlighten	argitu
punch	zulatu
mind-blowing	gogaikarria
victimize	biktimizatzeko
deceitfully	zoritxarrez
pains	minak
slander	kalumniatu
comely	ondo
worsening	larriagotu
rhetorical	erretorikoa
excessively	gehiegi
self-sufficiency	autosufizientzia
condemns	kondenatzen
rust	herdoila
disbeliever	ezkondua
stutter	etzanda
complicit	konplize
disgust	nazkagarria
spirited	espirituala
calumniate	kalumnia
satisfied	pozik
foe	etsaia
deform	deformatu
blaspheme	blasfemak
insolent	errukitsua
receptive	harkorra
failure	porrota
negativity	negatibitatea
rile	azazkal
brilliances	distirak
restriction	murrizketa
outburst	irteera
intolerablely	intolerable
distressing	gogaikarria
innovative	berritzailea
record-setting	erregistro-ezarpena
contemptible	ahaztezina
draining	drainatzea
thoughtful	pentsakor
loving	maitekorra
intrusive	intrusiboa
enchanted	sorginduta
unintelligible	ulertezin
virus	birusa
chastisement	kastigintza
hates	gorrotoa
delighted	pozik
dense	trinko
skeptic	eszeptikoa
promises	promesak
beautiful	eder
catastrophic	hondamendi
precipitous	bizkor
advantageously	abantailatsu
fat	gantz
marvel	zoragarria
convoluted	konvoluted
dreary	zoritxarrekoa
appropriate	egokia
attraction	erakarpena
stereotypically	estereotipatuki
meticulous	zorrotz
heartbreakingly	bihotz-erdiragarri
undetermined	zehaztugabea
clears	garbitu
stigma	estigma
worriedly	kezkatuta
delusional	delirio
infection	infekzioa
greasy	koipetsua
appealing	erakargarria
ambivalence	anbibalentzia
traitor	traidorea
dubitable	zoragarria
useable	erabilgarriak
renewed	berrituta
liability	erantzukizuna
undermining	ahuldu
diplomatic	diplomatikoa
symptoms	sintomak
ecstasies	ekstasi
gainful	irabazi
twist	bihurritu
conspirator	konspiratzailea
imperfectly	inperfektua
conflict	gatazka
invincible	invencible
allergic	alergia
skeptically	eszeptikoan
rail	trenbide
starve	gosez
intractable	ezinezkoa
covetous	aberatsa
disdainfully	zoritxarrez
overturn	berreskuratzea
bombastic	bonbastarra
pig	txerri
epidemic	epidemia
stark	zorrotz
successes	arrakasta
speedy	azkar
sufferer	gaixo
fleer	arbolak
lackluster	faltagabea
assuring	bermatuz
disagreeing	desadostasuna
felicitous	zoriontsu
interests	interesak
expunge	desegin
unrelentingly	gupidagabe
cheer	animatu
capability	gaitasuna
ill-tempered	malgua
sensible	sentikorra
infallibly	infalibly
defamations	defamak
proactive	proaktiboa
drags	arrastatu
gutless	koldar
pleasingly	zorionez
glamorous	glamourra
concession	emakida
attractive	erakargarria
drunk	edan
wretched	zoragarria
elegance	dotorezia
obscures	ilunpetan
murderously	hiltzen
bitterness	amargura
demoralizing	demoralizatzea
talented	talentua
abyss	amildegi
savagery	basatiak
imperialist	inperialista
impartially	inpartzialki
uproarous	zalaparta
wealthy	aberatsak
omission	omisioa
inconstant	konstante
inconveniently	desegoki
tempt	tentazioa
celebrated	ospatu
rejuvenate	gaztetu
hegemony	hegemonia
calamitously	kalamitously
right	eskubidea
malevolently	gaizki
disdainful	ezezaguna
fruitless	fruitua
coherent	koherente
stunningly	zoragarria
unjust	bidegabe
blind	itsu
slut	puta
creaking	gurutzean
fragrant	lurrina
snobs	esnobak
amity	amatasuna
savages	basatiak
charmingly	xarmagarria
apathetic	apatia
susceptible	susmagarria
comfortably	eroso
incongruous	inozoa
traumatic	traumatikoa
spurious	ezpurutasunik
dubiously	zalantzazkoa
fiendish	zoragarria
subversively	subertsiboki
unusually	ohiz
inefficient	eraginkorra
acclamation	aitamena
impossibly	ezinezkoa
impiety	inbidia
handy	erabilgarri
consummate	kontsumitu
delightful	ederra
immense	izugarria
fraudulent	iruzurrezkoak
relentlessly	etengabe
falling	erortzen
golden	urrea
extraneous	kanpoko
corrode	korroda
defeats	garaipenak
wholesome	osasuntsua
belligerence	beligerantzia
credence	kredentziala
bruised	ubeldura
tremendously	izugarri
rotten	ustel
talent	talentua
embarrassingly	lotsagarria
regretful	damua
dawn	egunsentia
posturing	postura
bloody	odoltsua
curses	madarikazioak
obsessiveness	obsesio
soundly	soinu
lackeys	laztana
costlier	kostata
reckless	errukitsua
mighty	ahaltsua
audaciousness	ausarkeria
revenge	mendekua
admirable	miresgarria
disrespectfully	irresponsiboki
courageously	ausarki
brilliantly	bikain
relish	atsegin
dissolution	disoluzioa
dispensable	ezinbestekoa
modesty	apaltasuna
prisoner	preso
bewildered	harrituta
low-price	behe-prezioa
hindrance	oztopo
lucky	zortea
jeeringly	zentzuzkoa
absurdness	absurdua
achey	minduta
conspicuous	nabarmena
frustration	frustrazioa
denying	ukatuz
lawbreaker	lege-hauste
unreachable	ezinezkoa
realizable	eraginkorra
aggression	erasoak
lurking	lurpean
savaged	salbatuta
majesty	maiestatea
deter	detektatu
decrepit	gutxitu
tyrant	tirano
acclaim	ongietorria
incompetently	ezgai
excellent	bikaina
strongest	indartsua
reprehension	errepikapena
rot	usteldura
rivalry	lehia
expansive	zabala
favorited	gogokoagoa
weary	nekatuta
disproportionate	desproportionatua
anti-social	antisozialak
sporadic	esporadikoa
agreeableness	adiskidetasuna
misgivings	zalantzak
useful	erabilgarria
rascal	bihurria
downgrade	beheratu
principled	printzipioa
passionately	sutsuki
fascist	faxista
rapturous	eztanda
destroy	suntsitu
reprimand	amesgaiztoa
break-ups	hausturak
rightfully	eskubidea
drowning	ito
regrettable	zoragarria
uneven	desberdin
shroud	jantzi
soapy	xaboitsua
tranquility	lasaitasuna
unintelligile	ulertezin
halfhearted	zorionak
odor	usain
marvellous	zoragarria
cliche	klikhean
meaningless	zentzugabea
virulent	birulentzia
disquieting	gogaikarria
impudence	lotsagabetasuna
accusation	akusazioa
recession	atzeraldi
temper	tenperatura
fondly	zorionez
flaws	akatsak
offence	delitua
insubstantially	errugabea
unforeseen	ezustekoak
douchebag	ergela
incredible	sinestezina
irragularity	irragarritasuna
war-like	gerra-antzekoa
poisonous	pozoitsu
lackadaisical	faltaadaizkoa
freezes	izoztu
enmity	etsaitasuna
irrelevance	irrilevanti
doom	zorabioa
shipwreck	naufragio
arbitrary	arbitrarioa
nauseating	nazkatzen
allege	aliatu
tenderly	samur
finest	hobeak
works	lanak
pleasing	atsegina
warmth	berotasuna
dissed	dised
complements	osagarriak
offensive	iraingarritzat
darken	ilunpetan
disarray	desarray
catastrophes	hondamendiak
vagueness	zurrumurrua
detrimental	kaltegarria
shocked	harritua
steals	lapurtu
raving	erruki
evaluative	ebaluatzailea
warmhearted	beroa
distraughtly	distralyly
trustingly	fidagarria
streaky	maiz
speedily	azkar
sophisticated	sofistikatua
unsteadiness	ezegonkortasuna
downsides	desegokiak
bad	txarra
afflict	afaltzera
mysteriously	misteriotsu
election-rigger	hauteskunde-arduraduna
glad	pozik
crappy	txarra
downside	arazotxo
illogic	ilogikoa
reclaim	berreskuratzea
improbability	inprobability
loyalty	leialtasuna
addicts	adituei
measly	neurriz
unbelievable	sinesgaitza
freezing	izozteak
gentlest	zoriontsuena
radical	erradikala
severe	larria
rewardingly	aberasgarria
rage	amorrua
hung	zintzilikatu
mistress	maitale
leaks	ihesak
stains	orbanak
flounder	berrogei
blasphemy	blasphemia
self-destructive	auto-suntsitzailea
passionate	sutsua
cons	konts
strangely	bitxikeria
unbelievably	sinesgaitz
immorally	gaizki
straggler	estraggler
foolishness	ergelkeria
explosive	lehergai
dissention	diskete
hardship	oinaze
unlamentably	deitoragarri
faultless	gaizki
generous	eskuzabala
nourishing	elikatzen
scoffingly	sorginkeriak
distinction	bereizketa
securely	segurtasunez
aweful	beldurgarria
idealize	idealizatu
inconceivable	ulertezina
resentment	erresumina
hardliner	gogorra
flagrant	bortitza
culpable	gudua
violently	bortizki
humility	apaltasuna
criminal	zigor
entertain	entretenigarri
upgraded	berritua
distorted	distortsionatua
wrought	landu
peculiar	bitxiak
unclean	kutsatu
monstrosity	monstruitatea
brashness	beldurra
rational	arrazionala
complaint	kexa
honest	zintzoa
confessions	konfesioak
radically	erradikalki
oasis	oasi
cringed	gurutzatu
unforgettable	ahaztezina
swiftness	azkartasuna
impulsively	oldartsu
imprudent	zuhurtziagabe
burned	erre
slow-moving	motela
imposition	inposaketa
contradiction	kontradikzioa
variety	barietatea
idol	idoloa
irritate	narritagarriak
rremediable	irmotasuna
die	hiltzen
reasonable	arrazoizkoa
protests	protestak
commend	komentatzea
zealot	fanatiko
randomly	ausaz
bleed	odol
pessimistic	ezkor
sore	mina
anomaly	anomalia
well-known	ezagun
scary	beldurgarria
pessimistically	ezkutuan
vexation	gaitzespena
superficiality	azalekoa
erase	ezabatzea
messed	nahastua
fake	faltsuak
negligence	arduragabekeria
nepotism	nepotismoa
interesting	interesgarria
exhilaratingly	zorionez
rejoice	poztu
ironies	ironia
stimulate	estimulatzen
elegantly	dotorea
marvelousness	zoragarria
ignorant	ezjakin
accessable	eskuragarria
humiliation	umiliazioa
stupendously	zorionez
magic	magia
useless	alferrikako
repressive	errepikakorra
intelligent	adimentsua
stiffness	zurruntasuna
tolerable	toleragarria
complacent	atsegina
arrogant	harroa
faint	ahula
dead-cheap	hilda-merkea
bewilder	harritu
tiringly	nekagarria
troublesome	kezkagarria
commonplace	ohikoa
stolen	lapurtu
backwood	atzeratua
worthlessness	inutilitatea
instable	intsektuak
mistakenly	gaizki
trash	zakarrontzia
commodious	komodoak
cheerless	txundigarria
conceit	pentsamendua
agonizingly	hiltzear
assuredly	seguruenik
perilous	arriskutsua
crashes	kraskatzen
famed	famatua
spoilages	hondamena
self-sufficient	auto-nahikoa
disobedience	desobedientzia
muddy	loditsu
peculiarly	bereziki
disservice	desabantaila
traitorous	traidorea
effectual	eraginkorra
disloyal	desleial
murky	ilun
complain	kexatu
argumentative	argumentatzailea
ergonomical	ergonomikoa
retards	atzerapenak
chronic	kronikoa
senile	senil
stresses	estresa
standout	nabarmentzea
interference	interferentzia
horrible	izugarria
traduce	itzuli
trustworthiness	fidagarritasuna
indeterminably	indeterminabel
avalanche	elur-jausi
disaccord	desgaitu
aching	minduta
gullible	inozoa
virulence	birulentzia
disturbingly	kezkagarria
steal	lapurtu
dripping	tantaka
exterminate	suntsitzeko
rigidity	zurruntasuna
handier	handiago
pessimism	pessimismoa
tortures	torturak
troubled	nahastu
dreadfully	beldurgarria
threaten	mehatxua
wasted	alferrik
enthral	zoragarria
disapprobation	desadostasuna
enterprising	ekintzailea
revere	errespetatu
discredit	desenkusatu
enslave	esclave
ugly	itsusi
lavish	luxuzko
discord	desadostasun
inhuman	inhumano
incapable	ezgaituta
amiability	amabilitatea
harm	kalteak
prideful	harrotasuna
paradoxically	paradoxikoki
dismissively	baztertu
benefactor	ongile
joyous	pozik
frustrations	frustrazioak
distraction	distrazio
illuminating	argiztatzen
grating	sareta
irrationality	irrazionaltasuna
valiant	ausarta
ruthlessly	iruzur
mischief	gaiztakeria
self-humiliation	auto-umiliazioa
luster	distira
improve	hobetu
premier	lehenbailehen
aggressiveness	agresibitatea
selfinterested	berekoia
apologist	apologoa
affectionate	maitekiro
disconsolate	deskonposatu
perfect	perfektua
derisively	zoritxarrez
rubbish	zaborrak
frantic	frenet
unraveled	desblokeatua
vigilance	zaintza
gall	erkametzak
bomb	bonba
resurgent	berpiztea
dignified	dinamikoa
difficulties	zailtasunak
paralyzed	paralizatua
dissembler	desegileak
troubles	arazoak
grievous	zorigaiztoko
disregardful	ezezaguna
disastrous	negargarria
spoil	hondatu
emergency	larrialdi
wretchedness	zorigaiztasuna
contamination	kutsadura
fury	haserrea
contaminate	kutsatu
instructive	hezigarria
long-winded	hotza
idyllic	idilikoa
gems	harribitxiak
adjustable	erregulagarria
afford	ordaindu
exultation	salaketa
salute	salatu
outperform	gainditu
promoter	sustatzailea
monumentally	monumentalki
disquietingly	zoritxarrez
breaks	pausoak
lamentable	zoritxarrekoa
jealous	jeloskor
excellant	bikaina
whooa	noroa
negatives	negatiboak
fairness	zuzentasuna
exploitation	ustiapena
revitalize	berpizten
conspiracies	konspirazioak
humble	umila
reluctantly	errezeloa
superb	bikaina
cherished	maitatua
crisp	kurruskaria
oddest	bitxiena
equitable	egokia
seedy	zikin
invaluable	eskerga
inexpiable	ezinbestekoa
sticky	itsaskor
froze	izoztuak
meticulously	zorrotz
pretend	asmoa
unproductive	inprobisatzailea
disappointed	etsita
unrest	atsekabea
spectacular	ikusgarria
distrust	mesfidantza
bravery	ausardia
glitter	purpurina
dissatisfies	zorionak
killing	hiltzea
clamorous	gogorra
shortness	laburtasuna
gain	irabazia
fatally	faltan
prettily	ongi
dissatisfied	atsegina
limits	mugak
impurity	ezpurutasun
deterioration	hondatzea
anarchy	anarkia
guilt	errua
idolize	idolatu
impede	oztopatu
slashing	ebakitzen
mistake	akatsa
excessive	gehiegizkoa
derision	zoritxarra
triumphal	garaipen
optimism	optimismoa
denial	ukatzea
deplete	agortu
exceed	gainditu
excited	ilusioa
waning	ahultzen
dilemma	dilema
regreted	damua
reliable	fidagarria
disintegrates	desegiten
downhill	jeitsiera
affirmative	baiezkoa
subjected	jasan
superfluous	soberakoa
audiciously	entzunez
proven	frogatua
plea	epaia
allergy	alergia
forgetful	ahazkor
pauper	pobre
fanfare	fanfarrea
tension	tentsioa
selfish	berekoia
illuminate	argiztatu
uneconomical	garesti
honoring	ohorez
patriotic	patriotikoa
excoriate	desenkusatu
stuttering	toteltasun
haughty	altxorra
sickening	okaztagarri
amiss	gaizki
bewildering	harritzekoa
steady	egonkorra
reverence	begirunea
horrendously	izugarri
resound	berretsi
ironical	ironikoa
pillage	zakarrontzia
cannibal	kanibal
adulterated	faltsu
disintegration	desegituraketa
serene	sereno
venom	pozoia
nurturing	elikatzen
paradoxical	paradoxikoa
mobster	mafia
scream	garrasi
denunciate	salatu
inability	ezintasuna
trusty	fidagarria
courtly	gorteko
authoritative	autoritarioa
contrived	artekatua
positive	positiboa
unease	deserosotasuna
nefarious	gaiztoa
unjustifiably	bidegabeko
abominable	gorrotagarri
conciliatory	kontrataziozkoa
commiserate	komisarioa
celebrate	ospatzeko
embattled	harrituta
debility	ahultasuna
exhort	galdetu
snub	zoragarria
detraction	detrakzioa
encouraging	sustatuz
impeach	iruzur
disgracefully	zoritxarrez
quiet	lasai
invective	inbidia
monster	munstroa
sadden	tristea
dazzled	liluragarria
reticent	errespetu
saintly	santu
meddlesome	burugabea
depressing	depresioa
entrust	konfiantza
oppression	zapalkuntza
civility	gizalegea
sincerity	zintzotasuna
imposing	inposatu
silly	tonto
sneakily	isilean
lovable	maitekorra
niggles	eztabaidatzen
upseting	atsekabe
boycott	boikot
snappy	zoragarria
exciting	zirraragarria
figurehead	figurahead
malady	gaixotasuna
overstates	oztopatzen
facetiously	zorrotz
bleakness	ahuldu
honesty	zintzotasuna
maledict	gaiztakeria
attacks	erasoak
saint	santu
underestimate	gutxietsi
relief	erliebea
undecided	zehaztugabea
brotherly	anaia
phobia	fobia
aggressor	erasotzailea
swamped	zurrupatu
amusing	dibertigarria
aggrivation	erasoa
foolproof	ergela
disfavor	desatsegina
peach	mertxika
refined	findua
sinister	gaiztoa
underdog	gutxietsia
courageous	ausartak
calamitous	kalamitous
error	errorea
ache	mina
rewarding	aberasgarria
deviation	desbideraketa
irrecoverably	berreskuraezina
devastate	suntsitu
devastating	suntsitzaileak
laconic	laconikoa
dissidence	disidentzia
insulted	mindua
scourge	lautada
indifference	indiferentzia
appreciatively	apalki
strain	tentsio
perfection	perfekzioa
floored	zorua
crooked	torturatu
foresight	aurreikuspena
outrage	iruzur
fraud	iruzur
best-selling	best-sell
lower-priced	behe-tasatuak
phobic	phobia
frets	trinkotu
uncouth	gordin
rejection	errefusatzea
incoherent	inkoherentea
shark	marrazo
hatefulness	gorrotoa
brittle	hauskorra
foulness	leuntasuna
restrictive	murriztaileak
overwhelmed	larritu
sugar-coat	azukre-armarria
unbearable	jasanezina
racism	arrazismoa
whimper	kexu
prudently	zuhurki
overstatement	ahaztuz
harmonious	harmoniatsua
deluded	ahaztuta
unfavorable	desegoki
purify	purifikatu
allegation	alegazioak
miraculously	mirariz
maladjustment	okerra
erroneous	okerra
die-hard	hiltzen
ripoff	erauzi
dazzling	liluragarria
enticed	liluratuta
serenity	serenitate
prominent	nabarmena
wrongly	gaizki
revive	berpiztu
infringe	urratzen
confusions	nahasteak
annoy	ernegatu
undercut	ahuldu
irreplacible	erreplika
implausibly	inplizituki
conspire	konspiratzen
stigmatize	estigmatizatu
frightfully	beldurrez
bargain	ganga
convience	konbentzionala
racists	arrazistak
messes	nahastea
better	hobeto
audaciously	ausarki
ire	gorrotoa
redemption	erreskatea
vulnerable	zaurgarria
enthuse	entusiasmo
false	faltsua
enchanting	zoragarria
revoltingly	maltzurki
unaffordable	garestiegi
impotent	inpotentzia
advocate	defendatzeko
available	eskuragarri
downfallen	jaitsiera
trap	tranpa
encouragingly	animagarria
achievible	lorgarria
irritations	irritazioak
qualify	gaitu
stinks	zorabioak
deny	ukatu
discontent	atsekabea
bust	bustoa
unity	batasuna
merit	merezimendua
unfamiliar	ezezagun
invisible	ikusezina
audacity	ausarkeria
exellent	zoragarria
issue	arazoa
pale	zurbila
snappishly	zorrotz
ruining	hondamena
unknown	ezezaguna
spew	egotzi
dispirited	ahaztuta
windfall	zorabioak
prestigious	prestigioa
enjoys	gozatzen
misalign	desorekatu
redundancy	erredundantzia
oppressors	zapaltzaileak
fascinatingly	liluragarriak
desecrate	desegiteko
unwarranted	bidegabeko
flat-out	laua-out
erratically	erratikoki
anger	haserrea
good	ona
addicted	adikzioa
betray	traizio
concern	kezka
unstable	ezegonkor
averse	ausaz
molest	bortxatu
ax	aizkora
conveniently	eroso
devilment	deabrua
stimulating	estimulatzailea
arrogance	harrokeria
vivid	bizia
pitiful	zoragarria
protest	protesta
rectifying	zuzentzeko
loss	galera
dirt	zikinkeria
pitiless	zorigaiztoko
melodramatically	melodramatikoki
defective	akatsa
bankrupt	errua
triumphant	garaile
diligence	diligentzia
adamant	zorrotz
timid	tximinoa
blockhead	blokeatuta
spinster	neskazahar
cocky	oilarra
shallow	azaleko
intriguing	intrigazkoa
moronic	tontoa
inevitably	ezinbestean
loser	galtzaile
drippy	dardoak
warily	zorrotz
embarrassing	lotsagarria
smear	lohitu
stylized	estilizatua
dented	ahuldu
quicker	azkarrago
disrepute	ausazkoa
accurately	zehaztasunez
inexpensive	merke
revival	berpiztea
wisely	zuhurki
warmly	hotz
civilize	zibilizatu
infamously	gaizki
redeem	trukatu
miracle	miraria
ineffectualness	ezintasuna
pleases	atsegin
defunct	desagertua
discontentedly	atsekabez
barbarity	basatasuna
fast-paced	bizkor
condemnable	kondenagarria
clarity	argitasuna
exacerbate	areagotu
miraculous	mirarizko
restful	atsedena
productively	produktiboki
admiration	mirespena
isolate	isolatu
fabrication	fabrikazioa
guilty	errudunak
assure	ziurtatu
depressed	depresioa
warp	ahuldua
tumble	erori
horrified	izuturik
skillful	trebea
harmless	kaltegabeak
educated	hezitua
satisfactory	ona
misinform	desinformatu
pestilent	izurritea
bafflement	nahastasuna
nag	gogaitu
nervously	urduri
barbaric	basatia
starkly	zorrotz
dark	iluna
snobbish	harroputz
superficial	azalekoa
imaculate	imajitua
vain	harro
untenable	defendaezin
readily	erraz
collusion	konbinazioa
exaltedly	altxorra
ugliest	itsusien
horrifies	izutzen
filth	zikin
overtakes	gainditu
weak	ahula
poor	pobreak
guidance	orientazioa
ached	zorionak
intimacy	intimitatea
picturesque	pintoreskoa
altruistically	altruistaz
expertly	aditua
surpass	gainditu
horrific	beldurgarria
replaceable	ordezkagarria
wise	jakintsua
twisted	bihurritu
free	doako
brand-new	berri-berria
hazard	arriskua
enlightenment	ilustrazioa
grievances	gezurrak
fresh	freskoa
magnificently	bikaina
anxieties	antsietateak
impoverish	nekea
inaccuracy	zehazgabea
incessant	etengabe
effrontery	errukia
derisive	zoritxarrez
hurts	mina
disbelief	sinesgaitza
spewed	egotzi
risk	arriskua
loud	ozen
obscurity	iluntasuna
confrontation	konfrontazio
fame	ospea
assassin	hiltzailea
suffered	jasan
death	heriotza
earnestly	serio
cruelty	krudelkeria
recklessness	errukitsua
freakish	bizkorra
obsessions	obsesioak
pathetic	patetikoa
repression	errepresioa
forgetfulness	ahaztuz
warning	abisua
flutter	bultza
polluter	kutsatzaileak
impetuous	indartsua
improvement	hobekuntza
panic	izua
redundant	erredundantea
talents	talentuak
disagreeable	desatsegina
defamatory	zoritxarrekoa
sardonic	sardoniarra
torturous	torturatzaileak
crush	bihurritu
degradation	degradazioa
powerfully	indartsua
fleeting	iheskor
darker	ilunagoa
worrisome	kezkagarria
transparent	gardena
hearten	bihotzez
remorselessly	gogaikarriak
imperfection	inperfekzioa
annoyingly	gogaikarriak
destitute	desegokia
untimely	ezgaraiko
slur	leuna
electrify	elektrify
willingness	borondatea
decrement	jaitsiera
affable	afable
falsify	falsifikatu
excite	ilusioa
comical	komikia
hallmark	zigilua
whiny	kexatia
greatest	handiena
felicity	zoriontasuna
peeled	zuritu
uncompromisingly	temati
idiocies	idioiak
boredom	aspertasuna
falsely	faltsuki
confuse	nahastu
distinctive	bereizgarria
overbearingly	gainbearinglyly
incomprehension	ulertezintasuna
unobserved	oharkabean
unhappily	zoritxarrez
breeze	brisa
efficient	eraginkorra
inconsolable	desatsegin
abscond	lausoa
unnoticed	oharkabean
contradict	kontrakoa
softer	leunagoa
stern	popa
disconcerting	ezezaguna
aggrieve	zorigaiztoko
regard	kontua
critical	kritikoa
fairly	nahiko
profoundly	sakonki
cramped	zurrunbiloa
forbid	debekatu
busybody	lanpetuta
comforting	erosotasuna
insensible	ezezaguna
dead	hilda
puppet	txotxongiloa
expropriation	desjabetzea
denunciation	salaketa
terror	terrorea
alarm	alarma
obscure	iluna
hurt	minik
resistance	erresistentzia
lies	gezurra
disruptive	kalteak
immature	heldugabeak
strangle	harritzekoa
bulkyness	gogortasuna
pertinacity	egokitasuna
ample	zabal
bribery	eroskeria
scandalously	eskandaluz
startlingly	izugarri
pleasurable	atsegina
profusion	profusa
corrosion	korrosioa
pertinacious	egokia
skilled	kualifikatua
masters	maisuak
intermittent	etengabe
offensiveness	indarkeria
diligent	arduratsua
misfortune	zorigaitza
pointless	ezinezkoa
affinity	afinitate
sharp	zorrotz
purposeful	helburua
appeal	errekurtsoa
flagrantly	bortizki
shadowy	itzal
moron	tontoa
hampered	oztopatua
notably	bereziki
losers	galtzaileak
coerce	indarra
deterrent	disuasio
self-coup	auto-kolpea
felicitate	zoriondu
providence	probintzia
enjoyed	gozatu
recommendation	gomendio
stall	saltoki
veritable	benetakoa
distains	ezartzen
despotic	despotikoa
beggar	eskale
costly	garestia
contribution	ekarpena
rifts	erredurak
poorly	gaizki
phenomenally	fenomenikoki
clogged	blokeatuta
disquietude	diskete
condescend	kondesatzen
proper	egokia
peace	bakea
foul	nazkagarria
static	estatiko
vindictiveness	mendekotasuna
fallaciousness	erruduntasuna
exalted	goratu
cherish	erantsi
lavishly	izugarri
rightness	eskubidea
immaculate	inmaculada
baffle	nahastu
pity	pena
nourish	elikatu
abnormal	anormal
dissonantly	disonantly
craftly	artisau
ethical	etikoa
beseech	galdetu
comfort	erosotasuna
congratulatory	zorionak
resplendent	argitsua
arduous	arduragabekeria
ardently	gogotsu
thoughtfulness	pentsamendua
dent	hortz
courageousness	ausardia
exceptional	apartekoa
ridiculous	barregarria
respectable	errespetagarria
merry	zorionak
portable	eramangarria
negation	negatiboa
incognizant	ezezaguna
invaluablely	invaluable
examplar	adibideak
coward	koldarra
prodigy	prodigia
robust	sendoa
upsettingly	atsekabe
shamefully	lotsagarri
sweet	gozoa
idiotic	tonto
incorrigibly	ezohiko
growl	hazten
panoramic	panoramikoa
vindictively	iraingarri
enhances	hobetzen
lawful	legezkoa
acerbic	akerbikoa
snob	esnoba
outcast	baztertuta
dismissive	baztertzailea
smitten	zoritxarrez
redeeming	truke
capriciousness	bitxikeria
unbiased	ezberdina
award	saria
snare	ixteko
ease	erraztasuna
flare	erlantz
brave	ausartak
ruinous	hondamena
deprive	desegin
clog	ezkutatu
despairing	desesperazioa
obstinate	gogaikarriak
overstatements	oztopoak
errors	akatsak
screwed-up	izorratu
nobly	noble
rapturously	zoritxarrez
fatty	gantz
implausible	inplorable
dynamic	dinamikoa
overjoyed	zoriontsu
heartless	bihozgabea
disobedient	desobedient
accusations	akusazioak
burn	erre
lone	bakarti
disadvantaged	desabantailen
fumes	keak
disobey	desobedientzia
absent-minded	adigalkor
complaining	kexan
strange	arraro
calumnious	sutsua
decry	desenkriptatu
weakness	ahultasuna
forlorn	iraungita
womanizing	emakume-zale
prominence	protagonismoa
bright	distiratsua
jealously	jeloskor
syndrome	sindromea
hot	beroa
cry	oihu
extoll	zoragarria
persecute	jazarpena
loveliness	zoriona
illustrious	ilustratzailea
calming	lasaitzea
declines	baztertzen
high-priced	goi-tasatuak
afflictive	afrikazkoa
erosion	higadura
frighteningly	beldurtuta
richly	aberats
indebted	zorrak
disputed	eztabaidatu
vibrantly	biziki
embarrassment	lotsa
breakup	apurtu
challenging	erronka
isolation	isolamendua
pigs	txerriak
vindictive	iraingarria
reconciliation	adiskidetzea
awkward	trakets
unravel	desblokeatzeko
impermissible	onartezina
ecstatic	estutu
scathingly	zorrotz
morbidly	morbido
gleefully	zorionez
sloww	motel
immobilized	immobilizatua
divisive	zatitzailea
sufficiently	nahikoa
overtaking	aurreratzea
deteriorate	hondatu
thrilling	zirraragarria
madden	erokeria
skittish	lotsati
discomfititure	deskonfititure
inspiration	inspirazioa
opulent	opulentea
hotheaded	liskartia
dehumanize	deshumanizatzeko
sufficient	nahikoa
holy	santu
misstatement	okerra
licentious	lizentious
stupify	ergelkeria
perplexity	perplexitatea
penalize	zigortzea
vexingly	gogaituz
uphold	babestu
back-woods	atzeratua
improbable	ezinezkoa
corrosions	korrosioak
spade	espada
obsessive	obsesibo
superstitious	superstizioak
disgustingly	zoritxarrez
savior	salbatzailea
dominate	menderatzeko
punitive	punitiboa
cohesive	kohesionatua
masterful	magistrala
patient	pazientzia
regally	erregalment
partisans	partisanoak
stab	eskopeta
snazzy	dotorea
impressive	ikusgarria
bliss	zoriontasuna
weird	bitxia
hard	gogorra
poetic	poetikoa
fortunate	zorionekoak
concede	berretsi
tiresome	nekagarria
harbors	portuak
soft	biguna
underlings	azpimarrak
alluring	liluragarria
hogs	zerriak
flares	bengalak
shaky	itzal
shocking	hunkigarriak
lose	galdu
deceit	iruzur
accusing	akusatu
dependable	fidagarriak
fusty	zorrotz
splendid	bikaina
disapproval	desadostasuna
reprovingly	erruki
banalize	banalizatu
satisified	beteta
retardedness	atzerapena
calumnies	zibilizazioak
dripped	gotortu
meager	txikia
repudiate	baztertu
fleeing	ihesi
reliably	fidagarria
agonies	agoniak
temptingly	tentagarria
implicate	inplikatzea
uneventful	arrunt
danger	arriskua
industrious	lanpetuta
audacious	ausartak
flawless	bikain
happy	pozik
haste	presarik
loathe	otoitz
expeditiously	azkar
reprehensible	ustez
tranquil	lasaia
filthy	zikin
faster	azkarrago
apprehensively	ustekabean
calmness	lasaitasuna
stupidity	ergelkeria
hypocricy	hipokresia
risky	arriskutsua
propagandize	propaganda
culprit	errua
notoriety	notoriotasuna
mastery	menderatzea
gross	gordin
insightful	ikusgarria
weakening	ahultzea
prejudicial	aurreiritzia
abort	abortatu
dungeon	ziega
passiveness	pasibitatea
shoddy	zorrotz
disconsolately	desanimatu
vengeful	mendekari
fool	ergela
exhilarating	zoragarria
misery	miseria
cumbersome	gogorra
ecenomical	ekenomikoa
stupor	zorabioak
resounding	gogorra
ravage	hondamena
misleadingly	engainagarria
recommendations	gomendioak
unsettlingly	aztoratzen
gruesomely	zakarki
wholeheartedly	bihotzez
nonsense	zentzugabekeria
pure	purua
malign	maligno
apocalyptic	apokaliptikoa
impolitely	lotsagabe
monstrosities	monstrositateak
undisputable	ezinbestekoa
stodgy	zorrotz
beneficially	onuragarriak
impure	ezpuru
fancinating	fancy
callous	zoragarria
willingly	borondatez
deficiency	gabezia
intrigue	intriga
forceful	indartsua
disgraceful	zorigaiztokoak
scandalize	eskandalizatu
misrepresent	itxuraldatu
irreformable	erreformagarria
expulse	kanporatu
enrichment	aberasteko
irregular	irregularra
nastily	nazkagarri
afraid	beldur
grind	ehotzeko
productive	produktiboa
scam	iruzurra
infamous	gaiztoa
downcast	negargarria
inflammatory	hanturazkoak
cleanly	garbi
responsibly	arduraz
perfidity	perfidentzia
scandalous	eskandalagarri
humid	hezea
bleak	iluna
inevitable	saihestezina
dangerous	arriskutsua
individualized	banaka
accurate	zehatza
counterproductive	kontrapuntuak
contrasty	kontraste
villainous	gaiztoak
frost	izozteak
conflicting	gatazkatsuak
tenacious	gogorra
impugn	ukatzea
stringently	zorrotz
villian	etsai
dragged	arrastatu
phenomenal	fenomeno
rejoicing	poztu
unjustified	bidegabeko
lie	gezurra
slave	esklabo
enthusiastically	gogotsu
burning	erretzea
astonished	harrituta
harmoniously	harmoniatsua
appreciated	estimatzen
clearer	argiagoa
sensitive	sentikorra
confused	nahastu
prize	saria
compassion	errukia
mope	kexatu
hideousness	izugarrikeria
boiling	irakiten
disses	dises
judders	epaileak
protesting	protesta
humourous	txukuna
archaic	arkaikoa
childish	haur
autocrat	autokrata
impassioned	apasionatua
satisfying	zoriontsu
disrupt	eten
proficient	trebea
hastily	lasterka
spitefulness	gorrotoa
inconsiderate	desenkusatu
zest	zestoan
unfaithfully	desleal
stammer	balantzea
courage	ausardia
invigorate	bizkortzea
imperiously	inperio
playful	ludikoak
confound	nahastu
compliment	osagarri
onerous	onberak
baffling	nahasten
handicapped	oztopatua
miserable	zorigaiztoko
faults	hutsegiteak
pointlessly	etengabe
repulsed	erreprimitu
simplified	sinplifikatua
unorthodox	ezohiko
monotonous	monotonoa
excelled	bikaina
loveless	maitagarria
disreputable	ahaztezina
stagnant	geldirik
eloquently	elokuentez
agreeable	atsegina
correct	zuzentzeko
zealous	kartsu
sensationally	sentsazioz
busts	bustoak
tempest	tenperatura
shit	kaka
reprehensibly	ustez
onslaught	eraso
wariness	gerra
shrouded	jantzia
pest	izurriteak
low-rated	txikia
unsettled	aztoratua
rebellious	bihurriak
chaos	kaosa
outstandingly	nabarmen
overbearing	zorrotzagoa
delightfulness	zoragarria
unthinkably	pentsaezina
agonizing	hiltzear
demonize	demonizatu
venomously	pozoitsu
apocalypse	apokalipsia
concise	zehatza
amputate	amputatu
quarrel	eztabaida
commitment	konpromisoa
senseless	zentzugabeak
facilitate	errazteko
degradingly	degradazioz
trashed	zaborrontzia
uprising	altxamendua
alarmingly	kezkagarria
rectify	zuzentzeko
fearful	beldurgarria
attentive	adi
undercuts	ahultzen
slogged	lausotuta
virtue	bertute
joyfully	zorionez
slowest	motelen
knock	kolpatu
reluctance	erreakzioa
impertinent	inpertsonala
weed	belar-txarra
helplessness	ezgaitasunak
prestige	prestigioa
punctual	puntuala
high-spirited	goi-espiritua
absentee	absentea
toxic	toxikoak
awfulness	eskuzabala
nosey	muturluze
slaughtered	hilda
tenacity	gogortasuna
affluent	aberatsa
blockage	blokeoa
tenderness	samurtasuna
feint	pretenda
sincere	zintzoa
top	goian
admonish	ohartarazi
stimulative	estimulatzailea
supremacy	nagusitasuna
adaptive	moldagarria
drawbacks	desabantaila
unnerve	larritu
novelty	berrikuntza
struggle	borroka
smooth	leuna
prefers	nahiago
hysteria	histeria
benefits	onurak
disasterous	hondamendia
astoundingly	zoragarria
disappointment	etsipena
cheat	tranparik
problem	arazoa
smilingly	irribarrez
devastatingly	suntsitzaile
stridently	zorionez
accomplished	beteta
fantastic	fantastikoa
sober	serio
disinterested	desinteresatu
dissolute	disolbatuta
revengefully	mendeku
miraculousness	mirakuluzioa
unspeakable	ezezaguna
uproariously	zalapartatsu
unreasonable	burugabe
cynicism	zinismoa
vexing	gogaitzen
optimal	optimoa
complex	konplexua
asinine	asinina
petty	txikia
hardy	gogorra
stable	egonkorra
fatalistic	fatalista
innocuous	inozoa
carefree	zaintza
belligerent	beligerante
dying	hiltzen
imprecate	inpotentzia
acerbate	abestu
capriciously	bitxikeria
empathy	enpatia
bumped	jipoitu
vibrated	dardara
seasoned	ondu
obliterate	ezabatu
paltry	gaiztoa
bewilderment	harritasuna
undesirable	desegokiak
affirm	baieztatu
supported	onartuta
pretty	ederra
relapse	erreka
limp	garbitu
enticing	liluragarria
insanely	erruki
myth	mitoa
yay	bai
assult	berretsi
parasite	parasitoa
self-interest	berekoitasuna
blame	errua
refreshing	freskagarria
sturdy	gogorra
bunk	litera
applaud	txalotu
stew	gisatua
concessions	kontzesioak
ludicrously	ludikoki
cleanliness	garbitasuna
unreadable	irakurtezina
poisonously	pozoitsu
extortion	estortsioa
fun	dibertigarria
effective	eraginkorra
memorable	gogoangarria
direly	zuzenean
traumatized	traumatizatua
atrocities	itzelkeriak
provoke	eragiten
hothouse	hazi
gratifyingly	zorionez
uproar	zalaparta
drastically	erabat
murderer	hiltzailea
painfully	zoritxarrez
kill	hiltzeko
expel	kanporatzea
worries	kezkak
contaminated	kutsatutakoa
sharper	zorrotzagoa
unimaginably	sekulako
mysterious	misteriotsua
violators	urratzaileak
aggravating	larriagotu
inspirational	inspirazio
disarm	desarmatu
militancy	militantzia
champion	txapelduna
abuses	abusuak
priceless	preziorik
object	objektu
self-defeating	auto-garaituz
worryingly	kezkagarria
dogged	zoritxarrez
insignificant	hutsalak
sensations	sentsazioak
happily	zorionez
discompose	deskonposatu
authoritarian	autoritarioa
vibrates	dardara
enjoyably	atsegina
indifferent	indiferente
decent	duina
inconsolably	desatsegina
villains	estaiak
obscured	ilunduta
halfheartedly	zintzotasunez
qualm	kualm
ugliness	itsustasuna
anarchistic	anarkistikoa
provocative	probokatzailea
noisy	zaratatsua
wisdom	jakinduria
cruelness	krudelkeria
sloooooooooooooow	motel
privileged	pribilegiatua
discontented	atsekabea
best	onena
painfull	mina
benevolence	benevolentzia
lethal	hilgarria
reasonably	arrazoizkoa
righteously	zuzenki
nitpick	eztabaidatu
venerate	gurtzen
angry	haserre
sinisterly	gaizto
hacks	hakeatzen
liking	gustura
important	garrantzitsua
sarcastic	sarkastikoa
amicable	lagunartekoa
eagerness	afektua
slump	jaitsiera
restrict	mugatu
insulting	burlatia
opinionated	iritzi
bitter	mingotsa
avid	abidia
navigable	nabigagarria
reverently	erreberentzia
paramount	funtsezkoa
depressions	depresioak
discordant	diskordantea
nitpicking	eztabaidatzen
louder	ozenago
believable	sinesgarria
intransigence	intransigentzia
viciously	bihozgabe
destabilisation	desestabilizazioa
itching	azkura
frustrate	frustratu
vehemently	sutsu
elevate	altxatu
discourage	desadostasuna
painful	mingarria
adversarial	kontrako
choppy	gogorra
volatile	lurrunkorra
uneasy	deseroso
morality	moralitatea
inhibit	inhibitu
despotism	despotismoa
success	arrakasta
weaknesses	ahuleziak
luckier	zoriontsuago
surmount	gainditu
scandel	eskandelua
incompatability	inkomunikazioa
bulky	handiak
catastrophically	hondamendi
midget	bitxikeriak
chivalrous	zaldibar
venomous	pozoitsu
scarcity	eskasia
asinininity	asinininitatea
flourishing	loratzea
mislead	engainatu
magical	magikoa
threatening	mehatxatzaileak
agreeably	atsegina
uncaring	bihozgabe
unlawfully	ilegalki
horrifys	izutzen
helped	lagundu
inefficiently	eraginkortasunez
promising	itxaropentsua
brutalities	bortizkeriak
doubt	zalantza
terrific	zoragarria
endorsed	onartua
worse	okerragoa
tangled	nahaspilatuta
revolutionized	iraultza
infallibility	infalibility
poverty	pobrezia
excitement	ilusioz
revives	berpizten
interruption	etenaldia
crowdedness	jendetza
confusion	nahasmena
contemptuously	etsipenez
brilliant	liluragarria
interrupt	eten
hottest	beroena
eagerly	irrikaz
beneficiary	onuraduna
repugnant	gaitzespena
rumours	zurrumurruak
suspicion	susmoa
bless	bedeinkatu
unfeeling	bihozgabe
truthfulness	egiazkoa
muscle-flexing	gihartsu
approval	onarpena
finer	finagoa
acumen	akumena
nagging	gogaitzen
profound	sakona
satisfactorily	ongi
cringes	belarrira
ambush	segada
remarkable	nabarmena
upset	minduta
crumpled	arrastaka
unnerving	larrigarri
peacekeepers	bakezaleak
tiring	nekagarria
debatable	eztabaidagarria
foully	gaizki
jeopardy	arriskua
unreal	irreala
simplify	sinplifikatu
upbeat	pozik
enhancement	hobekuntza
maliciousness	gaiztakeria
intimidatingly	intimidatiboki
barbarously	basati
diametrically	diametrikoki
wayward	galduta
benifits	onurak
accuse	akusatu
celebration	ospakizuna
stubbornly	zoritxarrez
accolade	agur
miscellaneous	hainbat
consistently	koherentziaz
whine	kexatu
illogical	ilogikoa
disillusioned	desengainua
betraying	traizio
impose	inposatu
back-logged	itzuli-saioa
warmer	beroago
toll	bidesaria
diabolically	diabolikoki
motivated	motibatuta
drawback	desegokia
inequitable	desegokia
impartial	inpartziala
irrecoverableness	berreskuraezintasuna
paralize	paralizatu
heaven	zerua
vile	doilor
acridly	zorrotz
savings	aurrezki
tempting	tentagarria
cruel	krudela
rhetoric	erretorika
hypocrite	hipokrita
crash	kraskadura
feasibly	bideragarria
surreal	surrealista
bleakly	ildaskak
abundant	ugari
steadiest	seguruena
rogue	gaiztoak
suffocate	asfaltatu
oblique	zeiharkako
mischievous	bihurri
equivocal	gaizki
spoils	hondamena
interferes	interferitzen
gentle	leuna
loathsome	gaitzesgarria
concerns	kezkak
insults	burlak
adulterier	adultero
harsh	gogorra
sugar-coated	azukre-estalitakoa
eruptions	erupzioak
denunciations	salaketak
peaceful	baketsua
insubordinate	inurriak
disordered	nahastuta
unexpectedly	ustekabean
nourishment	elikadura
cheesy	cursi
lonely	bakardadea
believeable	sinestea
reactionary	erreakzionarioa
hypocrisy	hipokresia
barbarically	basati
brutality	basakeria
polite	adeitsu
doubtful	zalantzazko
unorthodoxy	ezohiko
subpoena	aipamena
freedom	askatasuna
dextrous	zoragarria
straighten	zuzentzeko
dreadful	izugarria
distasteful	desatsegina
covenant	itunarekin
frightening	beldurgarria
violator	urratzailea
divisively	zatiketa
deviate	desbideratu
predicament	iragarpena
impasse	geldialdia
dizzy	zorabioak
pleas	eskakizunak
crummy	desenkusatu
scenic	eszenikoak
conspiracy	konspirazio
injustice	bidegabekeria
slack	moteldu
despair	etsipena
limitations	mugak
dissing	dising
depression	depresioa
hasty	presaka
break	apurtu
emptiness	hutsunea
stinging	izterrak
saver	babeslea
inimically	inimikoki
unnerved	larritua
satisfy	asetzeko
facetious	zoragarria
usurper	usurpatzaile
inventive	asmatzailea
exultant	zoragarria
quieter	lasaiagoa
dissident	disidente
proud	harro
worthless	ezerez
reconcile	konbinatu
faithful	leiala
smoke	kea
annoyances	gogaikarriak
downfall	erorketa
neatly	ondo
obscene	lizun
inspiring	inspiratzailea
sadly	zoritxarrez
snobish	harroputz
unequivocally	inequivocally
messing	nahasten
painless	indartsua
extol	itzaltze
regret	damua
startling	harrigarria
supportive	solidarioa
safe	segurua
glow	distira
brutal	bortitz
festive	jaiak
impersonal	inpertsonala
retreated	erretiroa
unsound	ezegonko
acrimony	akrimonia
enrapture	enrazia
sickly	gaixoa
ferociously	ferozki
evenly	berdinarekin
undisputably	ezinbestean
creative	sormena
wrong	gaizki
sad	tristea
patience	pazientzia
fortitude	gotorlekua
discriminatory	diskriminazioa
viewable	ikusgai
dispute	gatazka
predatory	harraparia
incorrect	okerra
noises	zarata
plusses	lurra
revulsion	berpiztea
liberation	askapena
pricey	preziatua
devoid	gabekoa
barbarian	barbaroa
mendacious	mendazkoa
unjustly	bidegabe
intimate	intimo
congestion	pilaketak
uproarously	zalapartatsu
advantage	abantaila
clunky	burdina
aggrieved	kaltegarriak
betrayals	traizioak
lawlessness	inportantea
primitive	primitiboa
tetchily	dotorea
eschew	ezkutatu
effectiveness	eraginkortasuna
caricature	karikatura
qualified	sailkatua
pretence	aurpegia
severity	larritasun
catastrophies	hondamendiak
irrationals	irrazionalak
faith	fedea
trapped	harrapatuta
graciousness	zoriontasuna
perseverance	iraunkortasuna
entice	liluragarria
captivate	liluratzeko
abomination	izugarrikeria
supporting	laguntza
comfy	komertziala
booming	indartsua
conscientious	kontzientzia
spiritual	espirituala
delinquency	delinkuentzia
estranged	kanpoan
vengeance	mendeku
sweetheart	maitea
cancer	minbizia
stooges	zorabioak
hideous	izugarria
irate	gorrototsua
unequal	desberdin
heal	sendatu
sicken	nazkatu
anti-occupation	anti-okupazioa
extinguish	itzaltzea
fume	smoke
incomprehensible	ulertezina
drunkard	betaurreko
ashamed	lotsatu
bothersome	gogaikarria
dishonesty	desatsegina
distort	distortsionatu
problematic	problematikoa
fans	zale
heavenly	zeruko
mistakes	akatsak
undersized	txikiegi
congratulations	zorionak
grace	grazia
unlamentable	deitoragarri
ambivalent	anbibalentea
opposition	oposizioa
scoff	esnatu
rumors	zurrumurruak
gainfully	irabazi
graciously	zorionez
absurdly	absurdu
articulate	artikulatu
deceitfulness	erruduntasuna
frozen	izoztuak
gracefully	graziaz
slime	lohi
dungeons	ziegak
relaxed	lasai
skillfully	trebeziaz
exaggeration	gehiegikeria
discouragingly	gogoz
grief	mina
contaminating	kutsatzea
upheld	berretsi
declaim	deklarazioa
dragging	arrastatu
rejoicingly	errealki
set-up	konfigurazioa
fibber	zuntz
thriving	aberatsa
downhearted	zorionak
advanced	aurreratuak
foolhardy	errugabea
irrational	irrazionala
dull	tristea
undermine	ahuldu
dishonor	deshonra
charitable	ongintza
invader	inbaditzailea
affectation	afekzioa
shamelessly	lotsagabe
screw-up	bihurritu
momentous	indartsua
unfaithful	desleal
beautifullly	ederra
direness	gizakiak
classic	klasikoa
resilient	elastikoak
musty	beharra
restored	zaharberrituta
wondrous	zoragarria
deceptive	engainagarria
tricky	delikatua
rightful	eskubidea
imperfections	akatsak
incapably	ezgai
romantically	erromantikoki
instrumental	instrumentala
guarantee	bermea
overthrow	desegin
stormy	ekaitza
fall	erori
beloved	maiteak
shady	itzala
slanders	kalumniatzen
lovably	maitagarria
licentiousness	lizentiousness
anti-us	anti-aeb
demolish	eraistea
extraordinarily	izugarri
fashionably	modan
crude	gordin
officious	ofizialak
groundless	behean
conceited	harrotua
recourses	baliabideak
righteous	leiala
pain	mina
devil	deabrua
wonderous	zoragarria
greatness	handitasuna
renaissance	berpizkundea
resourcefulness	baliabide
accusingly	jakitun
regression	errepresioa
bothers	gogaikatzen
enflame	inflazioa
intricate	konplexua
dope	dopia
adversity	zoritxarrean
rip-off	erauzi
desolate	desolatu
kindness	adeitasuna
ready	prest
wastefulness	hondamendia
heretical	heretikoa
arrogantly	harro
capricious	bitxiak
triumphantly	garaile
feign	fintasun
backwoods	atzeratua
self-interested	berekoia
hateful	gorrotagarria
affability	afektibitatea
disingenuously	ezertarako
heroic	heroikoa
cooperative	kooperatiba
disconcert	deskonposatu
fair	azoka
ruthless	errukitsua
consistent	koherentea
intrusion	intrusioa
personages	pertsonaiak
piety	pietatea
rapt	harrapatu
pleased	pozik
quitter	askatzailea
burden	zama
annoyance	gogaikarriak
recessionary	recessive
impaired	kaltetuta
infuriated	zorigaiztokoak
hype	higadura
damaged	kaltetuta
tentative	tentagarria
occluded	ezkutatuta
incongruously	ezohiko
break-up	apurtu
desert	basamortu
agility	arintasuna
fascism	faxismoa
restricted	mugatua
banish	baztertu
inefficacious	inertzia
arduously	arduraz
swipe	mugitu
acclaimed	txalotua
fried	frijituak
bashful	lotsatia
easiest	errazena
insignificantly	gutxi
harms	kalteak
drunken	borracha
mists	eztiz
helpful	lagungarria
favored	onartua
stiff	gogorra
fooled	engainatu
cruelest	krudela
fractious	lausoak
extremism	muturrekoa
decline	beheratu
worrying	kezkagarria
fault	akats
alarming	kezkagarria
disappoint	etsi
vice	bizio
dissocial	disocial
fright	beldurra
weaken	ahuldu
difficult	zaila
frustrates	frustratu
left-leaning	ezker-leaning
delusions	ilusioak
hideously	izugarri
exceled	bikaina
payback	berreskuratzea
menace	mehatxu
calumny	kalumnia
unwell	gaixo
unsteadily	ezegonkor
striving	ahalegintzen
evildoer	gaiztoak
succes	arrakasta
blackmail	xantaia
masterpieces	maisulanak
appreciate	eskertzen
slaughter	sarraskia
stagnation	gelditzea
haughtily	hautsily
rusts	oxidazioak
flexible	malgua
impending	inprenta
instigate	instigatu
hells	infernuak
romanticize	erromantizismoa
respite	atsedena
wrinkled	zimur
powerless	indartsua
destruction	suntsitzea
distract	oharkabetu
uglier	itsusiago
concerned	kezkatuta
diligently	arduratsuan
resigned	dimisioa
damages	kalteak
apprehension	atxiloketa
painlessly	indarrez
oppressively	oposizioz
wrangle	gezurra
infraction	infracciones
dilapidated	hondamena
cringe	krudelkeria
stifle	itzaltzea
marveled	zoragarria
enliven	animatu
disapointment	deuseztatzea
blissful	zoriontsu
ingeniously	ingeniaritza
murderous	hiltzailea
murder	hilketa
stubbornness	estubbornness
cautionary	kontuz
crumples	tumuluak
passe	pasatu
undone	desegin
futurestic	etorkizuna
scant	gutxi
vex	gogaitu
dismal	tristea
crushed	xehatu
competitive	lehiakorra
accolades	ahotsak
exhilaration	zorionak
spontaneous	espontaneoa
savvy	adituentzat
obstructed	oztopatu
fruitful	emankorra
unlimited	mugagabea
captivating	liluragarria
polluters	kutsatzaileak
infirm	gaizki
dejectedly	zoritxarrez
ultra-crisp	ultra-kurruskaria
encroachment	inbasioa
bored	aspertuta
overwhelming	gogorra
sinful	bekatari
lament	pena
extermination	sarraski
rapport	txostena
sprightly	beldurrez
slogs	lelopean
fulfillment	betetzea
tortured	torturatu
vanity	harrotasuna
suck	zurrupatu
enviously	inbidia
condescending	kondentsatzen
corrupting	ustelkeria
dismalness	zoritxarra
confession	aitortza
squabbling	zurrumurruak
satirical	satirikoa
sourly	gatz
insubstantial	ezohiko
obscenity	lizintasuna
stranger	arrotza
accommodative	ostatua
morbid	morbidoa
hollow	hutsak
cancerous	minbizia
meddle	nahastu
badly	gaizki
endanger	arriskuan
complaints	kexak
slaves	esklabuak
lemon	limoi
taxing	zergak
fascinating	liluragarriak
ecstasy	lortu
laid-off	ezkondua
thrilled	pozik
anti-semites	antisemitak
positives	positiboak
totalitarian	totalitarioa
harass	jazarpena
imprudence	zuhurtziagabetasun
odd	bakoitiak
firmer	segituan
imperious	indartsua
debts	zorrak
illegitimate	ilegala
erroneously	erruki
disdain	deskontua
attack	erasoa
confounded	nahastu
gaiety	jolasa
discountenance	deskontua
renunciation	renusioa
squirm	ezkutatu
distressed	ahaztuta
assault	eraso
smelly	usaina
scarce	gutxi
apprehensive	apala
backward	atzeratua
wrestle	borroka
remorsefully	zoritxarrez
defects	akatsak
inconsequently	ezezaguna
vociferously	ozen
goodly	ongi
cure	sendatzea
thrill	emozioa
absurd	absurdua
ecstatically	bereziki
deadly	hilgarria
crumbling	desegin
mendacity	mendazitatea
improperly	gaizki
martyrdom	martirio
avenge	mendekatu
conflicts	gatazkak
desperation	etsipena
complication	konplikazioa
execrate	exekutatu
lull	laztana
tarnished	jantzita
slooow	motel
tattered	zapaldu
truthfully	egiazki
heartening	aberatsa
neglected	ahaztuta
tarnish	laztandu
diversified	dibertsifikatua
outbursts	irteerak
fresher	fresherago
luxuriously	luxuzko
intimidating	intimidazioa
dread	beldurra
egotistically	egotistikoki
impress	harritu
earnest	serio
zealously	kartsu
indignation	indignaci√≥n
thirst	egarria
reputation	ospea
inglorious	gaiztoak
suppression	ezabatzea
sedentary	sedentarioa
immaterial	ez-materiala
objections	objekzioak
substantive	substantiboa
eminence	eminentzia
wild	basatia
thorny	arantzaduna
feverish	sukarra
infamy	infamia
thicker	lodiagoak
adaptable	moldagarria
dangerousness	arriskutsua
deserving	merezi
obtrusive	eskuzabala
fortunately	zorionez
nervous	urduri
smelling	usaina
unassailable	ezinbestekoa
incense	intsentsu
harassment	jazarpena
doubts	zalantzak
efficacious	eraginkorra
contravene	kontrakoa
limited	mugatua
happiness	zoriontasuna
easiness	erraztasuna
woebegone	zorigaiztoko
hilarious	barregarri
unexpected	ustekabeko
unskilled	ez-gaitu
consternation	kontsternazio
prattle	praktikoa
displaced	desplazatu
imprecise	zehaztugabea
repulse	errebotea
divine	jainkotiarra
washed-out	garbitua
accomodative	ostatua
excites	ilusioz
precise	zehatzak
passive	pasiboa
oddly	bitxi
dehumanization	deshumanizazioa
brighten	argitzeko
difficulty	zailtasun
incitement	haserrea
drop-out	utzi
tops	gailurretan
broken	hautsita
verifiable	egiaztagarria
anarchism	anarkismoa
grievously	gaizki
reaffirm	berretsi
admire	miresten
suffering	sufrimendua
engaging	bimbela
twists	bihurritu
clean	garbitu
coarse	lodia
conflicted	gatazkatsua
drain	drainatzea
disabled	desgaituta
guiltily	erruz
homage	omenaldia
stingy	zoragarria
abound	ugari
violent	bortitza
livid	larria
hurted	minik
dissappointing	desabantaila
laughingstock	barreak
disgustful	zorigaiztoko
scars	orbain
treachery	trebetasuna
anomalous	anomalo
excitedly	ilusioz
abusive	abusiboak
throbs	ekaitzak
loathing	gaitzespena
cruelly	krudelki
unsettle	aztoratu
suffer	sufritu
euphoric	euforikoa
famine	gosea
slick	beltza
reputable	fidagarria
excruciating	izugarri
rancor	erreskate
occluding	ezkutatzea
enthralled	liluratuta
goodness	zoriona
imprison	espetxeratu
simplistically	sinplista
adventurous	abenturazale
disconcerted	ezezaguna
hang	zintzilikatu
exorbitant	exorbitante
back-wood	atzeratua
leer	irakurri
reformed	berritua
appreciable	apala
fevers	sukarrak
time-honored	denbora-ohore
powerful	indartsua
cronyism	kronismoa
bitch	puta
comfortable	eroso
criticized	kritikatu
gloom	iluna
apathy	apatia
headway	aurrera
restructured	berregituratua
devastates	suntsitzen
recommended	gomendatua
somber	serio
devastation	suntsipena
mistaken	oker
entertains	entretenitzen
envy	inbidia
belligerently	beligerantea
cataclysmically	katakolikoki
languid	laranja
dumps	zabortegiak
lowly	txikia
excallent	harrigarria
eccentricity	eszentrikotasun
scare	uxatzeko
insincerely	gaizki
privilege	pribilegioa
demon	deabru
pertinaciously	egokiaz
invidiously	gaizki
sweetly	gozoki
oversight	zaintza
demonic	demonikoa
dissonant	disonantea
scared	beldur
draconic	draconiko
protested	protestatu
scandals	eskandaluak
devastated	suntsituta
straightforward	erraza
endorsing	onartuz
unrelenting	gupidagabe
staunchly	larriki
entrapment	harrapaketa
mad	ero
abominably	gorrotagarri
regretfully	zoritxarrez
steadiness	egonkortasuna
snag	harrapakin
rants	jarioak
wonderful	zoragarria
righten	eskuinera
neurotic	neurotikoa
cleanest	garbiena
rupture	haustura
cheapest	merkeena
drastic	zorrotza
missed	galduta
accidental	ustekabeko
embarrass	lotsa
snobby	harroputz
compatible	bateragarria
delight	gozamena
byzantine	bizantziarra
obnoxiously	gorrotagarri
reassure	lasaitu
compactly	trinkoa
superficially	gainazalean
delicate	delikatua
failures	hutsegiteak
enviable	inbidiagarria
bleeding	hemorragia
darkness	iluntasuna
disagreement	desadostasuna
persecution	jazarpena
gallantly	galantly
sluts	putak
effigy	efigia
winner	irabazlea
accomplish	betetzeko
lividly	bizirik
striking	deigarria
terribly	izugarri
irrationalities	irrazionaltasunak
inconsistency	inkonformitate
wickedness	maltzurkeria
obstacle	oztopoa
defect	akatsa
errant	errante
inequities	desberdintasunak
polarisation	polarizazioa
cheating	iruzurra
reaffirmation	berretsi
secretive	idazkera
stingingly	zorrotz
starvation	gosez
sustainable	iraunkorra
mockeries	burlak
disingenuous	desengainua
cripple	elbarri
splitting	zatitzea
enraptured	zorrotz
eccentric	eszentrikoak
dispiriting	desaktibatuta
awards	sariak
critics	kritikak
contempt	mespretxua
inpressed	inprimatuta
wrongful	gaizki
throbbing	birikak
fanatics	fanatikoak
delirium	delirio
unsatisfactory	onartezin
hoax	iruzurra
dauntingly	gogorra
bothered	kezkatuta
falls	jaitsierak
injustices	injustiziak
creaks	errautsak
luckiness	zoriontasuna
cracks	pitzadurak
compliant	betetzea
furiously	amorruz
miseries	miseriak
adverse	alderantzikatua
desiring	desiratzen
dishonorable	desatsegina
earnestness	seriotasuna
madman	ero
offending	hausteagatik
hardships	oinazeak
disavowal	desadostasuna
excruciatingly	zoritxarrez
insane	erokeria
disinclination	desinfekzioa
wripped	urratu
thinner	meheagoa
embroiled	hunkituta
stylish	dotorea
fathomless	zoritxarrez
scathing	maltzurkeria
fiction	fikzioa
craftily	artisau
betrayer	traizio
marvelous	zoragarria
sucker	salmenta
drains	drainatzen
sever	ebaki
sickeningly	okaztagarri
ailing	gaizki
truthful	egiazkoa
brainless	burmuina
invigorating	bizkortzea
maturely	madarikatu
dislocated	dislokatua
sweetness	gozotasuna
adored	adoratua
setbacks	atzerakadak
versatile	polifazetikoa
fallacies	falazia
rife	errepikatu
dissatisfactory	desatsegina
uncompromising	temati
boggle	nahastu
remedy	erremedioa
disagreed	desadostasunak
deficient	ahula
repugnantly	errefuxiatu
capitulate	kapitulatu
prefered	nahiago
master	maisu
complicated	konplexua
tricked	engainatu
obstruct	oztopatu
feasible	bideragarria
respect	errespetua
shamefulness	lotsagarritasuna
insignificance	ezezaguna
advocates	defendatzaileak
affordable	merkean
drag	arrastatu
stupified	zentzuduna
blow	kolpe
confrontational	konfrontazio
lucrative	irabazi
capably	gaably
ungrateful	eskergabe
irritant	irritante
admiring	miresten
dissatisfy	zoritxarrez
achievable	ezinbestekoa
immovable	higiezina
suspicious	susmagarria
disastrously	gaizki
bruising	ubeldura
mortification	mortifikazioa
bruises	ubeldurak
declining	beherantz
skeletons	eskeletoak
annoys	gogaitzen
over-awe	gainbehera
gallant	galant
disagreeably	desatsegin
naughty	bihurriak
craziness	zoriontasuna
stringent	zorrotzagoa
awful	beldurgarria
recover	berreskuratzea
whores	putak
tormented	oinazetsu
doomed	kondenatua
insensitivity	ezintasuna
vigilant	zaintzailea
dissatisfaction	atsekabea
responsive	sentikorrena
scrap	txatarra
disclaim	baztertzekoa
complains	kexak
pretense	aurpegia
hegemonism	hegemonismoa
illusions	ilusio
raping	bortxatzen
smelled	usaina
improbably	ezinbestean
persevere	perseveratu
outcry	gorrotoa
complement	osagarri
struggles	borrokak
rumple	zurrumurrua
barbarous	barbaroak
overthrows	desegin
villianous	villainous
self-serving	berekoia
effectively	eraginkortasunez
breathtaking	harrigarria
fortuitous	fortuitoa
inconvenience	eragozpenak
prohibitive	debekagarria
mystery	misterioa
wary	zuhur
merrily	zorionez
obstinately	zoritxarrez
infections	infekzioak
honored	ohore
prosecute	epaiketa
disable	desgaitu
disprove	baztertu
loneliness	bakardadea
disheartening	desoreka
preoccupy	kezka
boost	bultzatzea
excitedness	ilusioa
puppets	txotxongiloak
overshadow	oihuka
inadverent	nahigabeko
absence	absentzia
cutthroat	ebaki
forfeit	galdua
stellar	izar
bullying	jazarpena
loathly	zoritxarrez
transgression	transgresio
defeating	garaituz
loves	maite
mightily	agian
cold	hotza
assurance	bermea
drained	xukatu
plunderer	lapurtera
longing	irrika
legendary	mitikoa
rightly	ondo
concens	kontzentratzen
punish	zigortzea
depressingly	depresioa
authentic	benetakoa
picket	pipeta
daunting	gogorra
like	bezalakoak
contagious	kutsakorra
screech	garrasi
damage	kalteak
unwieldy	handiegia
incredibly	izugarri
dubious	zalantzazko
unlucky	zoritxarrez
impair	kaltetu
stealing	lapurreta
nauseates	nazkatzen
nasty	nazkagarria
savage	basati
massacre	sarraskia
hesitant	zalea
hero	heroi
prison	kartzela
promptly	laster
trouble	arazoak
egregiously	zoritxarrez
stronger	indartsuagoa
indeterminate	zehaztugabea
crumple	bihurritu
continuity	jarraitasuna
retard	atzerapena
hostage	bahitu
bolster	indartu
nefariously	gaizki
understandable	ulergarria
formidable	zoragarria
scandal	eskandalua
convincing	konbentzitzen
flexibility	malgutasuna
paradise	paradisua
crippling	lausotu
bruise	ubeldura
corrupts	usteltzen
sloooow	motel
adulterate	faltsutu
undermined	ahulduta
cursed	madarikatua
disconsolation	deskonposizioa
imposers	inpertsoreak
lying	etzanda
harshly	gogorra
wellbeing	ongizatea
salutary	osasuntsua
lead	beruna
assassinate	hiltzen
angel	aingeru
tangles	zaratak
bombardment	bonbardaketa
discriminate	bereizi
babble	lardaskatu
refresh	freskatu
involuntarily	nahigabeko
zeal	zelo
forged	forjatu
trickery	trikimailu
sorrowfully	zorionez
subjection	subjektua
amazing	harrigarria
encroach	eraso
humiliating	umiliatzen
extraordinary	apartekoa
hack	hakeatu
respectfully	errespetuz
smiling	irribarrez
unwanted	nahigabeko
destroyer	suntsitzailea
jealousy	jelosia
condescendingly	zoritxarrez
dismayingly	lotsagabe
inept	inepto
seething	haserre
graft	injertoa
cataclysm	kataklismoa
justly	justikoki
prolific	ugalkorra
impressed	harrituta
notorious	ezaguna
scapegoat	txapela
debt	zor
dropout	utzi
deviousness	dibulgazioa
niggle	eztabaidatu
entertaining	entretenigarria
inessential	inerteak
unreasonably	burugabe
disintegrate	desegin
upheaval	altxamendua
egotism	egotismoa
unlawfulness	ilegaltasuna
stupidest	ergelena
demonizing	demonizatzea
contradictory	kontraesankorra
encouragement	bultzatzea
polution	poluzioa
glory	aintza
losses	galerak
feeble	ahula
terrorism	terrorismoa
ridiculously	barregarria
-	-
very	oso
very	asko
incredibly	zoragarri
absolutely	guztiz
awfully	ikaragarri
enormously	izugarri
extremely	izugarri
horribly	ikaragarri
seriously	benetan
pretty	nahiko
too	gehiegi
really	benetan
most	gehien
more	gehiago
-	-
no	ez
not	ez
can't	ezin
won't	ez
doesn't ez
don't	ez
shouldn't	ez
n't	ez
didn't	ez
couldn't	ezin
wouldn't	ez
-	-
little	pixka
enough	nahiko
-	-
can	dezake
can	daiteke
could	zezakeen
could	zitekeen
might	liteke
might	beharbada
might	agian
should	beharko
